access|获取 n. 接近，入口
project|工程；课题、作业
intention|打算，意图
equivalence|等值，相等
negotiate|谈判，协商，交涉
disappointing|令人失望的
alternative|代替品
generous|慷慨的
biological|生物的
strategy|策略，战略
paradox|悖论；自相矛盾
primary|主要的，基本的
standpoint|立场
grab|抢先，抢占，抢夺
crucial|至关重要的
flaw|缺点；错误
depressed|萧条的；沮丧的
obstacle|阻碍
automatic|自动的
passionate|热情的
gambling|赌博
logic|逻辑
theory|理论
download|下载
signal|信号 v. 发信号，打信号；示意
authoritative|权威的
smooth|光滑的
institution|社会公共机构；制度；设立，制定
vehicle|车辆
plague|使困扰
psychological|心理上的
shade|阴凉处
persistent|持续的；坚持的
voluntary|自愿的，主动的
tolerance|宽容，容忍
senior|老年人
individual|个人
contemporary|当代的，现代的
opposite|相反的
specialize|专业从事
content|内容
philosopher|哲学家
unrest|不安定，动荡
startle|吃惊
emission|排放，辐射
overweight|超重的
occupation|职业，工作
mainstream|主流
scholarship|奖学金
contract|合同
cheek|脸颊
interdependence|相互依靠
import|进口 v. 进口
fiction|小说，虚构的文学作品
upbringing|养育，培养，教养
preserve|保护
vitally|极其重要地
masculine|男性的
advocate|倡导 n. 提倡者，拥护者，鼓吹者
dust|灰尘
track|足迹 v. 追踪，〔循着踪迹、气味等〕找寻
confidence|信心
riotous|狂暴的
sophisticated|复杂的；世故的
similar|相似的
transform|改变
approve|赞成，同意
session|开会，会议
awareness|意识
exhaust|使筋疲力尽
subsidize|提供补贴
grocery|杂货店
ignorance|无知，愚昧
intelligence|智力，智慧，理解力
tiny|微小的
praise|赞扬，赞美
memorize|熟记，牢记
relative|相对的 n. 亲戚
breakthrough|突破
incidence|几率，发生率
scratch|抓，划痕
harmful|有害的
undergo|承受
recession|衰退
extraordinary|非凡的
improper|不合适的，不适当的
marginalize|边缘化，排斥
vital|重要的
fortunately|幸运地
commencement|毕业典礼
fetch|取回
clumsy|笨拙的，不圆滑的
establishment|确立
emit|发出，排出
entertaining|有趣的，使人愉快的
irregular|不规律的
psychologist|心理学家
era|纪元，年代
triumph|胜利
detection|侦查；察觉
cozy|舒适的
gallery|美术馆
enormous|巨大的
obtain|获得
desert|抛弃
aviate|驾驶飞机
determine|决定；下决心
disappear|不见，消失
entitle|使具有权利，使具有资格
relieve|解除，减轻，缓解
generosity|慷慨，大方
colleague|同事
undertake|承担
convenient|方便的
preferentially|优先地
column|专栏
affectionate|深情的，柔情的
issue|发表〔声明〕 n. 问题
inquire|询问
groundlessly|无缘无故地，无根据地
independently|独立地
approach|靠近 n. 方法
administration|管理；〔某一时期的〕政府
adversity|逆境，不幸
technician|技术员，技师
regular|有规律的，经常的
miscalculation|算错，误算
hinder|阻碍
selection|选择，挑选
tide|潮水
superior|上级的，较高的 n. 上级，长官
matter|要紧，重要
passively|消极地
grant|授予；允许
liberation|解放
observe|遵守
institute|建立 n. 〔从事科研或教育等的〕机构；学院；研究院
dormitory|宿舍
awful|可怕的，骇人的
emergency|紧急情况
stress|压力；重音
launch|发动
suppose|料想，以为；假定；期望
remove|消除，移除
exposure|暴露；揭露
promote|促进，提升；推销
engage|从事；吸引
uncertain|不确定的
accommodate|为…提供住宿
slave|奴隶
mature|成熟的
contrast|对照物 v. 对比
clinic|诊所
award|授予；判给 n. 奖(金)
worthwhile|有价值的
cruelty|残暴，残酷
threaten|威胁
chemical|化学的 n. 化学制品
consistent|一致的
renew|〔中止后〕重新开始，继续
takeoff|起飞
innocent|无辜的；天真的
currently|当前；一般地
dropout|辍学者
replace|代替
sightseeing|观光
honor|荣誉；崇敬，敬重，敬意
imitate|模仿
installment|分期付款
personality|个性，性格
headquarter|设立总部，在…设立总部
ingredient|成分，原料
revenue|收入
sensitive|敏感的
particular|特别的，特指的；讲究的；挑剔的，吹毛求疵的
tumor|瘤
consequence|结果，成果
explicitly|直接地，明确地
sway|影响
technical|技术的
expert|熟练的，内行的
harm|损害；危害；伤害 v. 伤害，损害〔某事物〕
imaginary|虚构的，想象的
contaminate|污染，弄脏
soar|猛增
solely|单独地，唯一地
tremendous|巨大的
civilization|文明
tough|困难的
gift|礼物；天赋
scale|规模；比例
injure|使受伤
embrace|拥抱；欣然接受，乐意采纳 (新思想、意见、宗教等)
seldom|很少，罕见
performance|演出；履行；表现
violate|违反
associate|把……联系起来；交往；
privacy|隐私
choke|使窒息
capable|能干的，有能力的
appeal|呼吁 v. 吸引；呼吁；恳请，恳求
careless|粗心的
hit|(唱片、电影或戏剧的) 成功；命中，击中
swallow|咽下，吞下
consult|咨询
preservation|保存，保留
distance|距离
plastic|塑料的
predict|预言，预测，预告
submit|提交
entertainment|娱乐
critical|批评的，爱挑剔的
transaction|交易，业务，事务
via|通过
insist|主张，坚持
distract|分心
subdivision|分支; 分部
yield|产生，得出〔结果、答案或资料 n. 产量
misunderstand|误解
detail|细节
immeasurable|无法估量的
convincing|令人信服的
donate|捐赠
compare|比较，对照
item|〔尤指清单上、一群或一组事物中的〕一项，一件，一条
concrete|具体的
govern|管理，支配
classify|把…分类，把…分级
restrict|限制，限定
establish|建立，创办，设立
counseling|咨询服务
majority|多数
contact|联系，接触 v. 〔写信、打电话〕联系〔某人〕
virtual|虚拟的
simplicity|简单
enrollment|入学人数
programming|〔计算机的〕程序编写，程序设计；程序；；〔电视或广播〕节目；电视[广播]节目策划，编排
device|装置，设备
previous|之前的
alter|改变
coach|教练 v. 当…的教练，训练，培训
crisis|危机
interconnect|相互联系
enrich|丰富；使富有
poll|民意调查
consent|允许，同意 n. 同意，赞同
utility|公用事业〔如煤气、电力等〕
poisonous|有毒的，有害的
collision|冲突，抵触
rank|具有…等级[地位] n. 衔，阶层
fundamentally|根本上
inflation|通货膨胀
secure|确保……安全
interpret|解释
criticize|批评；评论
arrest|逮捕
afford|负担得起
implementation|实现，履行
initiate|开始，发起
enable|使能够……
narrow|狭窄的
overcharge|向……多收费
shortcut|捷径，近路
leisure|悠闲，空闲
original|原始的，最初的
density|密度
sphere|球体；范围
margin|页边的空白，页边，白边
department|部门
desire|渴望，欲望
legend|传奇
dictator|独裁者；专制者
diversity|多样性；差异
quit|放弃
outgoing|开朗的；外向的；外出的
solution|解决，解答，解决办法
revenge|报仇
reverse|相反情况；正相反 a. 相反的
enroll|注册
logically|合乎情理地，符合逻辑地
rental|租金
component|成分
quotation|引文
faith|信任
invalid|无效的
invade|侵入，侵略
separately|分别地，另行
strain|扭伤，拉伤
accessible|易接近的
lap|〔坐着时的〕大腿部
character|角色
widespread|普遍的，广泛的
rearrange|重新安排
hospitalize|就医
avail|有益, 有帮助
instant|立即的；紧急的；速溶的，方便的
democratic|民主的
barely|仅仅，几乎不
vanish|消失
caregiver|照料者
harsh|严酷的
reliable|可靠的，可信赖的
massive|(尺寸、数量、规模) 非常大的
alcohol|酒精
pregnant|怀孕的
adapt|适应于
bogus|假冒的
slippery|滑的；模糊的，不明确的，
current|当前的
overwhelm|压倒，战胜
stressful|充满著压力的，充满著紧张的
toothache|牙痛，牙疼
eliminate|消除
terminal|终点站，航空站
severe|严重的
immobile|稳定的，不变的
diplomatic|外交的
candidate|申请求职者；投考者；候选人
fund|基金，储备； v. 提供资金
complacency|自满，满足
delight|高兴
inadequate|不足的，不够的
steady|稳定的，逐步的
accurate|精确的，准确的
identification|身份证明；鉴定，识别；认同；
previously|事先
identical|相同的
retirement|退休
commit|犯罪；承担义务
element|要素；元素
assess|评价
hire|雇佣
represent|代表
overestimate|对（数量）估计过高
supervision|监督
expose|暴露
seemingly|表面上看
assignment|作业
preference|偏爱
energetic|精力充沛的
application|申请；应用
moral|精神上的, 道德的
dispute|辩论，争论 v. 辩论，争论
influence|影响 v. 影响
illegal|非法的
esteem|自尊
abundant|大量的，丰富的
survey|调查；审视，仔细考虑 n. 调查；勘测，测量，测绘
extensively|广泛地
deserve|值得
crash|坠落;坠毁;撞击 n. 〔汽车的〕撞车事故；〔飞机的〕坠毁，失事
affirm|断言，声明
reputation|名气，名声，名誉
degree|程度
fade|逐渐消失
competitor|竞争者，对手
confuse|使混淆，迷惑
task|任务，工作
lessen|减少
admit|承认；容许
bow|鞠躬
division|除法；部门
literature|文学，文学作品；文献；文献
consultant|顾问
penalty|惩罚
comment|评论
major|主要的 v. 主修
option|选择
socialize|交往，联谊
bureau|局
budget|预算 v. 编预算
pop|突然出现，跳出
position|职位
unaffordable|买不起的，负担不起的
function|功能 v. 运行
perceive|察觉
reserve|留出，预定
innovation|改革，创新
alert|提醒；使〔某人〕意识到 adj. 机警的
cautious|谨慎的
document|文件
characterize|以……特点
achieve|完成，实现
address|解决
inspiration|灵感
agency|机构
formulate|规定，制定
fate|命运
surf|冲浪
steer|驾驶
structure|结构
architect|建筑师
frame|框架
amaze|使吃惊
affirmation|断言，肯定
intelligent|有智慧的，聪明的，悟性强的
code|代码，密码
burden|重担，负担
absorb|吸收（液体、气体等）
instruction|用法说明；操作指南；命令，指示
admission|承认；准许进(加)入；入场费
additional|额外的
prejudice|偏见 v. 使有偏见，使有成见
process|过程，进程；；工序；工艺流程 v. 处理
elegant|优雅的
hospitable|热情友好的
refreshing|恢复活力的
ensure|确保
frighten|使惊恐，使恐慌
civilized|文明的
approval|批准，认可；赞成，同意
publicize|宣布
resident|居民
considerate|体贴的；考虑周到的
twist|扭曲，使弯曲
citizen|市民，城镇居民；公民
stake|风险
keenly|敏锐地
superficial|肤浅的
flexibility|灵活性；适应性
favorable|赞同的
competent|胜任的，有能力的
emotional|情绪(上)的，情感(上)的；激起感情的； 敏感的；情绪激动的〔尤指哭泣〕
pioneer|开拓，开发
sustain|维持
gloomy|阴沉的，沮丧的
convince|使相信
profitable|有利可图的，有益的
routinely|例行公事地
phenomenon|现象
variety|多样
gum|牙龈
criticism|批评
fatal|致命的，攸关的
delightful|高兴的
tedious|单调沉闷的
flexible|灵活的
considerably|相当地，非常地
efficiently|有效地
appearance|外表, 外观；出现
album|粘贴簿，集邮簿，册
optimistic|乐观的
clue|线索
grief|悲伤
synthetic|合成的，人造的
resistance|抵御，抵抗；抵抗力
install|安装
pledge|保证，誓言
unique|独特的，唯一的
stock|股票；库存
disadvantage|不利情况，缺点
compensate|弥补，补偿
rescue|营救，援救
monitor|监控；监听
refusal|拒绝
exile|流放，放逐
encourage|鼓励
concept|观点，观念
render|给予
trait|性格
feature|特点
reframe|再构造(图画、照片等)
identify|认出，识别；视为
impose|强加
snack|零食，小吃
require|要求，命令
donation|捐赠
equal|相等的，平等的
rare|罕有的，少见的
specify|指定，具体说明
constant|不断的，持续的
standardize|使标准化
consume|消费，消耗
status|地位
complement|补充
lengthy|长的，漫长的
embarrassed|尴尬的；窘迫的
rational|神智清楚的
distant|遥远的
homemaker|主妇
exception|例外
sustainable|可持续的
trigger|引发，引起
intend|打算
spread|扩散；传播
estimate|估计
technique|技巧，手艺；技术，技能
include|包含
academic|学术的
distinctive|独特的，与众不同的
consist|由……组成
bid|出价，投标 v. 出价，投标
benefit|有益于，有助于
downsize|裁员
avoid|避免
gender|性别
interracial|种族间的
complaint|抱怨; 投诉
pattern|模式
mood|心情
sympathy|同情心
discount|折扣
value|重视
altitude|海拔, 高度
groundsheet|防潮布
evolutionary|进化的；演变的
implement|实施，执行
dominant|占优势的
scope|范围
suspect|怀疑，猜想 n. 嫌疑犯
confrontation|冲突，对抗
puzzle|迷惑 n. 难解之事，谜
critic|批评家，评论家
apartment|公寓
analyze|分析
maintain|维持；主张
curb|控制 n. 控制
version|版本
rival|对手
beneficial|有利的，有益的
substantial|大量的
recover|恢复；重新获得；寻回
diploma|文凭
carpenter|木匠
circumstance|环境，境遇
canteen|食堂
advocator|主张者，倡导者
disorderly|杂乱的
essentially|本质上，根本上
prevent|预防
ceremony|典礼，仪式
assume|假定，认为
demand|需求，要求 v. 要求
principle|原则，原理
reception|接待；反响
transfer|转换，调换 n. 转换，调换
preventable|可预防的
anticipate|预感
assumption|假定，假设
prescription|处方
evolution|演变，进化
annoy|使反感，厌烦
unintended|意想不到的
origin|起源
qualify|使……有资格
emergence|出现，发生
complain|抱怨
merit|优点，成绩 v. 值得
forum|论坛
arrange|安排，筹划
determination|意志
bargain|便宜货，减价品
appetite|欲望, 胃口
neutral|中立的
primitive|原始的；简单的；简单的，简陋的
therapy|疗法 治疗
conscience|良心
define|确定；下定义
creativity|创造力
tailor|调整使适应
dramatically|戏剧性地，引人注目地
panic|惊恐
motivation|激励，刺激
durable|持久的，耐用的
remedy|药物
inevitable|不可避免的
diverse|各种各样的
context|背景，环境
prominent|杰出的；突出的，凸起的
witness|目击者，目击
save|节省
inherit|继承
occasion|场合
initiative|主动权，自主权
insight|洞察力，洞悉
misguided|被误导的
sponsor|赞助
porter|搬运工
loyalty|忠诚，忠实
overwhelming|压倒性的
appreciation|感激
setting|背景，环境
display|展览 v. 展览
deliver|发表
astonish|使惊讶，使大为吃惊
adequate|足够的
consumption|消费，消耗
abuse|虐待；滥用
broad|宽的
inappropriate|不合适的
worldwide|全世界范围地
strict|严格的
means|方法
reveal|揭露，揭示
confirm|证实
consensus|一致意见
agent|代理商
neighborhood|地区
participate|参与，参加
valid|有效的
initially|最初，起初
slightly|轻微地
objection|反对
atmosphere|气氛；大气；空气
assign|布置；分配
evidence|根据，证据，迹象
racially|种族上地
exclude|排除，不包括
available|可利用的，现有的；可获得的
puzzling|令人困惑的
evaluation|评价，评估
irritate|激怒
distinguished|显著的，杰出的
depressing|令人沮丧的
mutually|互相地
mission|使命，任务；代表团
migration|迁移，移民
site|场所，地址
expectation|期望
update|更新；使现代化
gear|齿轮 v. 使合适
reproductive|生殖的，再生的
incredible|不可思议的
backward|向后
raise|提高；筹款；抚养
prohibit|禁止，阻止，防止
bother|麻烦；打扰
pose|摆姿势，装腔作势 n. 姿势
instrument|仪器，器械，工具
mask|掩饰
essential|必须的；本质的
harvest|丰收，收获
reject|拒绝，驳回
advancement|进步，提升
skyrocket|突升，猛涨
characteristic|特点
implication|含义，暗示
measure|分量 v. 测量
replacement|代替
easygoing|脾气随和的，温和的
squeeze|压，榨
exhibition|展览
responsibility|责任
enhance|提高；加强；增加
retain|保留,留用
convey|传达，传递
regulation|管理；规则
integrity|完整
combine|联合，结合
impermanency|非永久性
catalogue|把……编入目录
council|议会
prepare|做准备
inquiry|询问
tension|紧张
prompt|迅速的；立刻的；及时的 v. 促使；激励
attendance|出席人数
retail|零售 v. 零售
image|形象，声誉，；印象
quantity|量，数量
inspector|检查员
endurance|耐力
simplify|简化
range|范围 v. 在范围内变化
accomplish|完成
treatment|治疗；对待
spare|空闲的
welfare|幸福；福利
boost|推动 v. 促使，促进
consciousness|意识
patiently|耐心地
decent|正派的，体面的
review|回顾 v. 复习
considerable|相当大(或多)的
misguide|误导
foundation|地基；基础；；基金会
postgraduate|研究生
prevail|流行，盛行
solid|扎实的，坚实的
counsel|忠告，建议
maximum|最大值，最大量 a. 最大值的，最大量的
abstract|抽象的
realistic|现实的，实际的
ban|禁止
ashamed|羞耻的；内疚的；惭愧的
solve|解决
reinforce|加强，强化
applicant|申请人
tuition|学费
persistence|坚持不懈
overcome|战胜，克服
bride|新娘
engagement|婚约
household|家庭，一家人
evaluate|评价
saint|圣人
delay|推迟，延期
private|私人的
definition|定义
influential|有影响力的
recommend|推荐；劝告；使受欢迎
frontier|边境
concern|重要的事情 v. 与…有关，关于
organ|器官
cite|引用
mechanism|机制，机能
contest|比赛
symptom|症状
deadline|最后期限
domination|主导
figure|人物；数字
imply|暗示；意味；
curiosity|好奇心
induce|引诱
acknowledge|承认(…的权威)
gym|体育馆，健身房
chef|厨师
sensible|明智的
outline|梗概，提纲，草稿，要点
react|对……作出反应
committee|委员会
civilian|平民，百姓
domestic|国内的
complex|复杂的
locate|位于，定位
tighten|使变紧
physics|物理，物理学
foothold|立足处（攀登时脚踩的地方）
discharge|释放；排出；批准离开; 命令离开
advanced|高级的
complicated|复杂的，难懂的
needy|贫穷的
stale|乏味的，没有新意的
casual|漫不经心的，随便的；偶然的
conform|相一致，遵守
recharge|再充电
annually|每年，一年一次
frown|皱眉
decline|下降，减少；拒绝
originate|开始
prospect|前景；前途
curious|好奇的
incentive|动机，刺激
virus|病毒
cultivate|培养， 养成
potential|潜力 adj. 有可能的；潜在的
reluctant|不愿意的，勉强的
miserable|痛苦的
persuasion|劝说
competitiveness|竞争力
restriction|限制，限定
minor|小的
grain|谷物，粮食
rate|比率，速率
radically|完全地，彻底地
distinct|明显的；有区别的
equality|平等
hardworking|苦干的，不辞辛劳的
qualification|资格(证明)，合格证书
bacteria|细菌
corporate|团体的；法人的
undermine|逐渐削弱; 逐渐动摇
selfish|自私的
cater|迎合
survival|幸存
favor|偏好, 较喜欢
conflict|冲突
client|客户
garage|车库
fatigue|疲劳，疲乏
plant|工厂
endanger|危及，危害，濒临危险
operation|手术；行动
handle|处理
laborious|费力的
passion|热情，激情
cooperative|合作的
inflate|(使)膨胀
resourceful|机智的
exaggerate|夸张
loan|贷款
vocabulary|词汇
illustrate|说明,阐明
overflow|溢出，淹没
fantasize|想象，幻想
amusing|有趣的，好玩儿的
universal|宇宙的，全世界的；普遍的
generate|产生
schedule|日程表
backslide|倒退，退步
particle|微粒
menu|菜单
reward|报答，奖赏 v. 报答，奖赏
reproduce|复制
worsen|（使）变得更坏
feedback|反馈
equivalent|相等的，相当的
resign|辞职
motivate|促动，激发，诱导
compel|强迫
revise|修订
dampen|抑制
prosperity|繁荣
flow|流动 v. 流动
humanity|人类〔总称〕；人性
sideways|向侧面
pursue|追求
innovate|创新，革新
mill|工厂
promotional|促销的
dump|扔下，倾倒；倾销
resist|抵抗，抗拒
source|来源
legal|法律的
picky|挑剔的
steal|偷窃
despite|尽管
explosion|爆炸
gap|缝隙，缺口；差距
relevant|有关的，切题的
ignore|忽视，不顾
complete|完成 adj. 完整的，彻底的
sufficient|足够的
switch|转变，改变
request|要求
stereotype|老套，固定模式
couple|夫妻，情侣
honesty|诚实
transportation|运输
physical|身体上的
screen|筛查
divine|神圣的
guideline|指导原则
revolution|革命
interruption|打扰；中断
dishwasher|洗碗机
promising|有希望的，有前途的
vary|不同；变化
permanent|永久的
manufacture|制造，生产
fussy|爱挑剔的；
dictate|命令，规定 n. 命令，规定
professional|专业的
prosper|繁荣
exchange|交换，交流 v. 交换，交流
concentration|集中
gesture|手势，姿势
deliberate|故意的
contribution|贡献；捐款
bless|保佑，祝福
detective|侦探
evident|明显的
retreat|退避，后退；撤退
responsible|负责的，有责任的
identity|身份
statistics|统计学；数据
appreciate|感激；欣赏
insult|侮辱
neglect|疏忽；忽视
primarily|主要地，首先
long|渴望
incline|倾向于
asset|有价值的人(或物)资产
overtake|超车
extension|分机
engine|引擎，发动机
emphasize|强调
genuine|真正的
fascination|魅力；入迷
lodge|住宿，暂住
cheat|欺骗, 作弊
security|安全，安保
painful|痛苦的，疼痛的，令人不快的
emerge|出现
instance|情况，例子
steep|陡峭的；急剧升/降的
rigorous|严格的
persuade|说服
procedure|程序
signature|签名
surpass|超过
campaign|活动
advance|提前 v. 前进
charity|慈善机构
average|平常的
indispensable|必不可少的
irrationally|不合理地，无理性地
accompany|陪伴
aviation|航空
distress|使痛苦，悲痛
invariably|不变地，一直
invest|投资
approximately|大约
conservation|保护，保存
ease|轻松，舒适
extracurricular|课外的
undoubtedly|无疑
excellent|卓越的，杰出的，极好的
investigate|调查
judgement|判断，决定
struggle|搏斗
prohibitively|过分地，非常地
military|军队的，军事的
consequently|结果
suffer|受苦；遭受（痛苦）
visible|看得见的
swift|迅速的
battle|战争，战役
liability|责任
resistant|抵抗的；抵制的
nutritious|营养的
constantly|不断地，时常地
familiar|熟悉的
terribly|可怕地，非常
restore|修复
refine|改善；精炼
inspire|激发；鼓舞；使产生灵感
comply|遵从
justice|公正
district|区
installation|安装；就职；就职仪式
marvelous|引起惊异的
provoke|激起，挑起
lobby|大堂 v. 游说
interview|面谈（试）；会见； v. 采访 ；面试
release|释放；发布
explore|探索
profound|深厚的
exploit|开采
startup|启动，开办
constructive|建设的，建设性的
unbearable|无法忍受的
laundry|要洗的衣服；刚洗过的衣物；洗衣房
seize|抓住
poison|使中毒
bakery|面包店
tent|帐篷
wedding|婚礼
fair|集市
geographic|地理的
comprehensive|综合的，全面的
riot|暴乱
conspicuous|显著地
block|阻碍 n. 街区
acute|敏锐的
endure|忍耐；容忍
assembly|装配
opponent|对手
confront|面对
stir|搅动；煽动，激起
rocket|火箭 v. 猛增
attribute|归因于
sentence|判决 v. 判决
tempting|诱人的，吸引人的
commitment|承诺，保证
feasible|可行的；可能的；可用的
outcome|结果
diligent|勤奋的
deprive|剥夺，夺去，使丧失
grid|输电网
distribute|分发
destruction|破坏
divide|分开
highlight|突出；强调 n. 突出的部分
justify|证明……正当
announce|宣布，声称
proposal|提议
advisory|报告，警告
mystery|迷，神秘的事物
punctual|准时的
derive|得到，导出
harmony|和谐
unwilling|不愿意的
view|看待
financial|财政的，经济的
priority|优先，优先权
impermanent|非永久（性）的；不持久的，暂时的
symbolize|象征
bankrupt|破产的，倒闭的
intake|摄入
addiction|上瘾
productive|富有成效的
admire|钦佩，称赞
reflect|反映
underline|强调
representative|代表
blame|指责，责怪
retrain|再教育；再训练
tasteless|无味的
excessive|过度的
dishonest|不诚实的
caution|小心，谨慎 v. 警告，告诫
glorious|辉煌的
pointless|无意义的
significant|重要的
mutual|相互的
temptation|诱惑，引诱
passive|被动的
evolve|使发展
treasure|珍爱
shock|感到震惊
disservice|伤害，帮倒忙
ambitious|有雄心的，野心勃勃的
fancy|华丽的；别致的
accumulate|积累，增加
fuss|大惊小怪
ultimately|最后，最终
showmanship|主持演出的技巧
cancel|取消
regulate|管理
peer|同龄人
calculate|计算
virtually|几乎，差不多
accustom|使习惯
retailer|零售商
programmer|程序设计员
advice|建议
admiration|钦佩，称赞
courageous|有勇气的
respectful|有礼貌的，尊重的
makeup|化妆品
reservation|预定
apply|申请；应用
demonstrate|证明；展示
generation|一代人；产生
chat|聊天
ancient|古代的
evil|邪恶，罪恶
indifferent|冷漠的
namely|即，也就是
effect|影响
devote|奉献，致力于
appointment|约会
appoint|任命，委派；约定，确定，指定
resemble|像，相似
assemble|集合；组装；集合
expressiveness|表达
visibility|能见度
distracted|分心的
debt|债务
substitute|代替者 v. 代替
insecure|不安全的
chap|小伙子，小家伙，家伙
selective|选择的,精选的
compensation|弥补，补偿
dilemma|困境
foreseeable|可以预见的
inadequacy|不足
guarantee|担保 n. 保证，担保
discrimination|歧视
intense|强烈的
facilitate|使便利，促进
mislead|误导
reassess|重新评估
response|反应
essay|散文，文章
stimulate|刺激
dessert|甜点
peaceful|平静的；和平的
regularly|定期地，有规律地
fascinate|强烈地吸引，迷住
durability|持久
discover|发现
constitute|组成
administrative|管理的
tremble|颤抖
ignorant|无知的
decorate|装饰
acquire|获得
annual|每年的
due|到期的
situation|情况
archive|档案馆，档案室；档案
incomparable|无比的，无可匹敌的
perspective|视角，观点；远景
compete|竞争
joint|联合的
overload|负担太重
mechanic|机械师
distinguish|区别，区分
vote|投票，选举
everlasting|永恒的
construction|建筑
aggressive|挑衅的，好斗的；有上进心的
classification|分类，级别
melt|融化
detect|觉察；检测
discourage|阻止；使气馁
combination|联合，结合
grave|坟墓
malfunction|失灵，故障
reduce|减少
respectively|各自地
forefinger|食指
wise|聪明的，有智慧的
background|背景
symbol|象征，标志
quality|品质
repave|再铺，重新铺砌
downfall|（雨等的）大下特下
ring|拳击台
planet|行星
pension|养老金
perception|感知
facility|设施
proportion|比例，部分
involve|卷入，包含
attempt|尝试，试图 v. 尝试，试图
conventional|传统的
detailed|细节的，详细的
interpretation|阐释，说明
guilt|有罪，犯罪行为
connectivity|连接，联系
behave|表现
instruct|指导；教授；通知；命令；
infinite|无限的
hazard|危险
undervalue|低估
specific|特定的，具体的
appealing|吸引人的
fitness|健康
conclusion|结论
absent|缺席的
antique|古玩，古董
myth|神话
intervention|干涉
trace|痕迹
protest|抗议
refuel|（给）加油，加燃料
tackle|处理
finance|财政 v. 资助
fine|罚款
indicate|表明
dissatisfy|不满意
expand|扩大
spontaneous|自发的
offense|犯罪；冒犯
abruptly|突然地
recycle|循环，再利用
rude|粗鲁的
contribute|捐款，贡献
embarrass|尴尬
weaken|减少，减弱
mineral|矿物
sticky|粘的
challenge|挑战 . v. 质疑
excess|过量，过度
recruit|招募，吸收 n. 新兵，新成员
overstate|夸张，夸大
generalization|概括
hub|中心
conservative|保守的，传统的
restock|重新进货，再储存
convict|证明…有罪
deepen|使加深，加剧
tank|油箱，水箱
negative|消积的；否定的
accelerate|加速
territory|领土，领域
impact|影响
distraction|分心；消遣
resolve|解决；下决心
refuse|拒绝
soluble|可溶的；可以解决的
brave|勇敢的；极好的
hat|帽子（一般指有边的）
beach|海滩，湖滩，河滩
authority|当局，官方；权力
roast|烤，炙；烘
amplify|放大，扩大；增强
bulk|大部分；体积，块头
put|放，摆；使处于
stable|稳定的，不变的
certificate|证书，证件，执照；（毕业）文凭，合格证书
dragon|龙
capable|有能力的；有才能的
criticism|批评；批判；评论
accommodation|住处；工作场所
imply|暗示，意指
december|十二月
president|总统；（某组织的）最高权力人
lately|最近，不久前
down|向下；在下面
matter|事情；物质 v. 要紧
lake|湖
nor|既不…也不…；也不
bench|长凳，条凳
rug|小地毯；毛毯
mirror|镜子 v. 与〔另一事物〕相似；反映
draw|画，划
net|网，网状物；互联网
scale|天平，磅秤，秤
outline|轮廓；略图；大纲
quiet|安静的；寂静的
water|水 v. 使湿，灌溉
nervous|神经的；易激动的
nevertheless|然而 adv. 仍然
assembly|集合；集会；装配
fight|打（仗）；斗争
missing|失去的；缺掉的
lift|提起，提高 n. 电梯
refrigerator|冰箱，冷藏库
dirty|脏的；下流的
rent|租金 v. 出租
convince|使确信，使信服
abroad|（在）国外
offend|冒犯 v. 犯罪，违法
belong|属于
arouse|引起，唤起；唤醒
admission|承认；允许进入
modify|更改，修改
express|表示 n. 快车；快递
imagine|想象，设想
infinite|无限的；无数的
barrier|障碍；栅栏；屏障
lane|（乡间）小路；跑道
notebook|笔记本，期票簿
realm|领域；王国，国土
lever|控制杆；杆，杠杆
midst|中部，中间，当中
pilot|飞行员；领航员
direct|直接的；直率的
prejudice|偏见，成见
tour|旅行，旅游 v. 旅游，游历
tolerance|忍受，容忍
discourage|使泄气，使灰心
get|获得，得到；到达；变成，成为
advertisement|广告
ribbon|缎带，丝带；带
partner|配偶；伙伴；搭挡
hamburger|汉堡包，牛肉饼
climb|攀登，爬
differ|不同，相异
exhibition|展览会；展览，陈列
mineral|矿物 adj. 矿物的
public|公众的 n. 公众
palace|宫，宫殿
pulse|脉搏；脉动；脉冲
immediately|立即；（immediately involved）直接地
cow|母牛，奶牛；母兽
private|私人的；私下的
toast|烤面包 v. 烘，烤
scenery|风景；舞台布景
fun|乐趣，娱乐；玩笑
living|活的 n. 生活，生计
mediterranean|地中海 adj. 地中海的
worth|值…的 n. 价值
conquer|征服；战胜
absorb|吸收；中文释义；使专心
enthusiasm|热情，热心，热忱
brood|同窝幼鸟 v. 孵（蛋）
tip|轻击；给小费
accompany|陪伴，陪同；伴随
execute|将…处死；实施
conceal|把…隐藏起来
certain|肯定的；确实的
apparent|明显的；表面上的
messenger|送信者，信使
merit|长处，优点
youth|青春；青年们；青年
naval|海军的，军舰的
downward|向下的 adv. 向下地
fact|事实；实际，实情
hut|小屋，棚屋
namely|即，也就是
monument|纪念碑；纪念馆
cool|凉的；冷静的
governor|州长；主管人员
program|程序；节目单
illness|病，疾病
normal|正常的，普通的
population|人口；全体居民
frontier|边境；边疆；新领域
quantity|量，数量，分量
order|次序；整齐 v. 命令
learning|学问，知识；学习
everywhere|到处，处处
stage|阶段；舞台
everyone|每人，人人
sting|刺；刺痛 n. 刺
hatch|（蛋）孵化；孵出
honey|蜜，蜂蜜
nest|巢；窝，穴
degree|度；学位
equivalent|相等的；等量的
calendar|日历，历书；历法
manual|体力的 n. 手册
cabinet|内阁；橱，柜
steady|稳固的 v. 使稳定
more|更多的 adv. 更
apple|苹果
never|永不，决不；不
instruction|命令；教学；教训
laughter|笑，笑声
appeal|呼吁；申述 v. 呼吁；申述
idiom|习语，成语
impressive|给人印象深刻的
fourteen|十四
on|在…上
stack|堆，垛 v. 堆积
imitate|模仿；仿效；仿制
cast|投，扔，抛；浇铸
pump|泵 v. 用抽机抽
animal|动物，兽 adj. 兽欲/动物本能等（animal urges/instincts）
mend|修补，缝补；修理
dozen|一打，十二个
bathe|给…洗澡
means|方法，手段，工具
emphasis|强调，重点，重要性
shortage|不足，缺少，不足额
contrary|相反的 n. 相反
tunnel|隧道，坑道，地道
visible|可见的，看得见的
minimum|最小量 adj. 最小的
hedge|篱笆，树篱
bundle|捆，包，束；包袱
stretch|伸展；伸 n. 伸展
electrical|电的，电气科学的
artificial|人工的；娇揉造作的
grateful|感激的
classmate|同班同学
assess|对（财产等）估价
personal|个人的；本人的
qualify|使具有资格
shift|替换，转移 n. 转换
preceding|在前的；在先的
board|板 v. 上（船、车等）
custom|习惯，风俗；海关
patch|补丁；〔与周围部分不同的〕斑，小块 v. 修补，缝补
jar|罐子，坛子，广口瓶
defeat|战胜，击败；挫败
child|小孩，儿童；儿子/女儿
education|教育；训导
stair|楼梯
ornament|装饰物；装饰
downstairs|在楼下 adj. 楼下的
hare|野兔
brook|小河，溪流
procedure|程序；手续；过程
employ|雇用；用；使忙于
may|modal verb. 可能；可以；祝
province|省；领域，部门
freeze|冻；结冻
artistic|艺术的；艺术家的
combination|结合，联合；混合
adapt|使适应；改编
ambulance|救护车
burden|担子，重担
innocent|清白的；幼稚的
option|选择；选择权
fee|费，酬金；赏金
greeting|问候，招呼，致敬
sincere|真诚的；真挚的
steel|钢，钢铁
guard|守卫；看守 n. 卫兵
worthy|值得尊敬的；值得的
breakfast|早饭，早餐
sympathize|同情；同感，共鸣
gallery|美术馆，画廊；长廊；走廊
notice|注意 n. 注意；通知
percentage|百分比，百分率
money|货币；金钱；财富
best|最好的；最大的
meet|遇见
crown|王冠，冕；花冠
beginning|开始，开端；起源
mathematical|数学的，数学上的
juice|（水果等）汁，液
meadow|草地，牧草地
district|地区，区域；区
fish|鱼；鱼肉 v. 钓鱼
incorrect|不正确的，错误的
lose|失去；迷失；输掉
man|男人；人；人类
mere|仅仅的；纯粹的
bell|钟，铃，门铃；钟声
mean|作…解释；意指
surrender|交出；投降
complicate|使复杂；使陷入
english|英语 adj. 英国人的
gardener|园丁，花匠
call|把…叫做；叫，喊
pleasant|令人愉快的，舒适的
conversion|转变，转化；改变
adopt|收养；采用；采取
master|能手；主人；硕士
pipe|管子，导管；烟斗
recover|重新获得；挽回
communicate|通讯；传达
bike|自行车 v. 骑自行车
classify|把…分类
trumpet|喇叭，小号
canoe|独木舟，皮艇，划子
entertain|使欢乐；招待
campaign|运动；战役
abandon|丢弃；放弃，抛弃
lorry|运货汽车，卡车
congress|大会；国会，议会
double|双的；两倍的
confident|确信的；自信的
extreme|极度的；尽头的
frequency|屡次；次数；频率
confess|供认，承认；坦白
lodge|暂住，借宿，投宿
apartment|一套公寓房间
elevator|电梯；升降机
kilogram|千克，公斤
industrial|工业的；产业的
explosive|炸药 adj. 会爆炸的
challenge|挑战
swear|宣（誓）；诅咒
departure|离开，出发，起程
elastic|松紧带 adj. 有弹性的
break|打破；损坏；破坏
capital|首都；资本，资金
adequate|足够的；可以胜任的
progress|前进；进展；进步
paste|糊；酱；糨糊
relevant|有关的，贴切的
exam|考试；检查，细查
conservative|保守的 n. 保守的人
inhabit|居住于，栖息于
ministry|（政府的）部
stem|茎，（树）干 v. 起源
margin|页边的空白；边缘；边缘
core|果实的心；核心
correspondent|通讯员；通信者
possibly|可能地；也许
roll|滚动；转动
repair|修理，修补 n. 修理，修补
moral|道德的；合乎道德的
broken|被打碎的；骨折的
steer|驾驶
wax|蜡，蜂蜡
centimetre|公分，厘米
gaseous|气体的，气态的
equal|相等的；平等的
lecture|演讲，讲课 v. 演讲，讲课
recommendation|推荐，介绍；劝告
bleed|出血，流血
kid|小孩，儿童；少年
become|变得；变成；成为
rid|使摆脱，使去掉
land|土地；陆地 v. 上岸
bold|大胆的；冒失的
prison|监狱；监禁
modest|谦虚的；不太大的；不很贵的
leather|皮革；皮革制品
length|长，长度；一段
academic|学院的；学术的
prosperous|繁荣的，昌盛的
grammatical|语法上的
physics|物理学
turbine|叶轮机，汽轮机
contempt|轻蔑；藐视；受辱
settlement|解决；殖民，殖民地
label|标签；标记，符号
dew|露，露水
professor|教授
nothing|没有东西 adv. 毫不
palm|手掌，手心
limit|限度；限制；范围
crude|简陋的；天然的
cold|冷的；冷淡的 n. 冷
frank|坦白的，直率的
forget|忘记，遗忘
bean|豆，蚕豆
appear|似乎；出现；来到
price|价格，价钱；代价
emotion|情感，感情；激动
worst|最坏的 adv. 最坏地
moan|呻吟声 v. 呻吟
terrible|可怕的；极度的
dollar|元〔美国、加拿大、澳大利亚等国的货币单位〕
answer|回答；响应
barn|谷仓；牲口棚
conclusion|结论，推论；结尾
demand|要求；询问；需要
learn|学，学习
rival|竞争者 adj. 竞争的
industry|工业，产业；勤劳
concern|关心，挂念；重要的事
friendly|友好的；友谊的
pale|苍白的；浅的
dramatic|戏剧的；引人注目的
rhythm|韵律，格律；节奏
local|地方的；局部的
nuclear|原子核的
gentleman|绅士；有教养的人
exactly|确切地；恰恰正是
shield|盾；防护物 v. 保护
hawk|鹰，隼
network|网状物；网络
disease|病，疾病；病害
french|法国的 n. 法国人
indicate|标示，表示；表明
aural|耳的，听觉的
basket|篮，篓，筐
interpreter|译员，口译者
mountain|山，山岳；山脉
obtain|获得，得到，买到
activity|活动；活力；行动
lung|肺脏，肺
throughout|遍及 adv. 到处
measurable|可测量的
clasp|扣子，钩子；别针
unit|单位；单元；部件
spring|跳，跃 n. 泉；跳跃
home|家；家乡 adj. 家庭的
grammar|语法；语法书
army|军队；陆军
clock|钟，仪表
domestic|本国的；家庭的
ladder|梯子，梯状物
doubt|怀疑；疑虑 v. 怀疑
fork|餐叉；叉；分叉
course|课程；过程；一道菜
intense|强烈的；紧张的
advice|劝告；忠告；意见
virtually|实际上，事实上
envy|妒忌；羡慕 n. 妒忌；羡慕
duck|鸭；中文释义: 雌鸭；鸭肉
remark|评论，谈论 v. 评论，谈论
native|本土的 n. 本地人
purchase|买，购买 v. 买
explode|使爆炸
tragedy|惨事，惨案；悲剧
scissors|剪刀，剪子
atom|原子；微粒；微量
suck|吸，吮，啜
flag|旗，旗帜
person|人；人身；本人
essay|短文；散文，小品文
cliff|悬崖，峭壁
perspective|透视；远景；观点
inquiry|询问，打听；调查
hair|头发；毛发；毛
clever|聪明的；机敏的
scratch|搔；抓 n. 搔；抓
insist|坚持；坚持要求
chimney|烟囱，烟筒
orphan|孤儿
plane|飞机；平面
accomplish|达到（目的）；完成
queen|女王；王后；王后
really|真正地；实在
hook|钩，挂钩 v. 钩住
recognition|承认；认出，识别
leaf|叶，叶子
preliminary|预备的，初步的
meeting|聚集，会合；会见
property|财产，资产；性质
correct|正确的 v. 纠正
month|月，月份
destination|目的地，终点
purse|钱包，小钱袋；手袋
feature|特征，特色；面貌
route|路，路线
error|错误，谬误；差错
trust|信任 v. 相信；委托
origin|起源，由来；出身
quick|快的；敏捷的
hunger|饿，饥饿；渴望
fearful|害怕的，可怕的
suspicion|怀疑，疑心，猜疑
knowledge|知识，学识；知道
dish|碟，盘子；菜肴
amuse|逗…乐；给…娱乐
cheque|支票
orchestra|管弦乐队
favourite|特别受喜爱的
centre|中心；中枢 v. 集中
come|来，来到；出现
lion|狮子；勇猛的人
berry|浆果（如草莓等）
edition|版本；版；版次
hatred|憎恶，憎恨，仇恨
poverty|贫穷，贫困
type|型，类型 v. 打字
process|过程；工序 v. 加工
pleasure|愉快，快乐；乐事
banner|横幅；旗，旗帜
experiment|实验；试验
pear|梨子，梨树
marxism|马克思主义
drip|滴下；漏水 n. 水滴
dictation|口授笔录；听写
advisable|明智的；可取的
tide|潮，潮汐；潮流
mind|头脑；理智；记忆
blow|吹；吹动；吹响
model|模型；模特儿
compass|罗盘，指南针；圆规
germ|微生物，细菌；幼芽
probably|或许，大概
library|图书馆；藏书
advance|前进；提高 n. 进展
my|我的
beloved|为…所爱的 n. 爱人
nephew|侄子，外甥
aluminium|铝
rarely|很少，难得
subsequent|随后的，后来的
charity|慈善事业；施舍
itself|它自己；自身
clue|线索，暗示，提示
jewish|犹太人的
current|当前的；通用的
journey|旅行，旅程
sustain|支撑；忍受；供养
enormous|巨大的，庞大的
bite|咬；咬，叮，螫；剌穿
gift|礼物，赠品；天赋
bullet|枪弹，子弹，弹丸
history|历史；个人经历
list|表，目录 v. 列举
behave|表现，举止；
new|新的；新近出现的
van|大篷车，运货车
amount|总数；数量；和
calculate|计算；估计
generous|慷慨的；宽厚的
conventional|普通的；习惯的
early|早 adj. 早的，早期的
number|数，数字；号码
hint|暗示，示意；建议
fashionable|流行的，时髦的
tolerate|忍受，容忍，宽恕
condense|压缩，使缩短
technician|技术员，技师
flash|闪光 v. 闪，闪烁
flour|面粉，粉；粉状物质
catch|捉住；赶上；领会
purple|紫色 adj. 紫的
feed|喂（养）；吃饲料
league|联合会；同盟，联盟
exert|运用；尽（力）
finding|发现；调查的结果
foreign|外国的；外来的
shave|剃，刮
assume|假定；承担；呈现
response|响应；作答，回答
refine|精炼，提纯
following|接着的；下列的
play|玩，游戏；演奏
steamer|轮船，汽船
lump|团，块；肿块
prince|王子；亲王
formation|形成；构成；形成物
inward|内心的 adv. 向内
plentiful|丰富的，富裕的
mutual|相互的；共同的
insurance|保险；保险费
humorous|富于幽默的，诙谐的
dissolve|使溶解；解散
prior|在先的；优先的
farther|更远地 adj. 更远的
liner|班船，班机
mist|薄雾
abuse|滥用；虐待 n. 滥用
exceedingly|极端地，非常
coil|（一）卷；线圈 v. 卷
foundation|基础；地基；基金
wit|智力，才智，智能
spin|使旋转；纺 n. 旋转
noise|喧闹声；响声；噪声
anticipate|预料，预期；期望
masterpiece|杰作，名著
illustration|说明，图解；例证
recent|新近的，最近的
laundry|洗衣房，洗衣店
compute|计算，估计，估算
difficulty|困难；难事；困境
representative|代表性的 n. 代表
electricity|电，电学；电流
past|过去的 n. 过去
alloy|合金；（金属的）成色
temple|圣堂，神殿，庙宇
feast|盛宴；筵席；节日
invitation|邀请，招待；请柬
group|小组，群 v. 聚集
visual|视觉的，视力的
atmospheric|大气的；大气层的
annual|每年的 n. 年报
stranger|陌生人；新来者
present|现在的 n. 目前
frog|蛙
music|音乐，乐曲；乐谱
simply|简单地；朴素地
heart|心，内心；勇气
substitute|代替人 v. 用…代替
easily|容易地
suspend|吊，悬；推迟
burn|烧，燃烧 n. 烧伤
workman|工人，劳动者，工匠
leadership|领导
jealous|妒忌的
can|罐头，听头；容器
cotton|棉；棉线；棉布
european|欧洲的 n. 欧洲人
explain|解释；为…辩解
natural|自然界的；天然的
clean|清洁的；纯洁的
rebel|造反 n. 造反者
enable|使能够，使可能
evident|明显的，明白的
rain|雨，雨水 v. 下雨
management|管理；经营，处理
eighth|第八 n. 八分之一
bread|面包；食物，粮食
sorrow|悲痛，悲哀，悲伤
cattle|牛；牲口，家畜
inspect|检查，审查；检阅
mental|精神的；智力的
mushroom|蘑菇，菌类植物
review|再检查 n. 复习
beautiful|美的，美丽的
descend|下来，下降；下倾
fahrenheit|华氏温度
freedom|自由；自主
grave|坟墓 adj. 严重的
lumber|木材；木料；制材
encounter|遭遇，遇到 n. 遭遇
atmosphere|气氛；大气；空气
toe|脚趾；足尖
touch|触摸；触动；感动 n. 触
troublesome|令人烦恼的；麻烦的
congratulation|祝贺；祝贺词
package|包裹，包，捆
part|一部分；零件
credit|信用贷款；信用
judge|法官；裁判员
original|最初的；新颖的
decision|决定，决心；果断
compose|创作；组成，构成
rag|破布，碎布，抹布
satellite|人造卫星；卫星
transport|运输 n. 运输
drawing|图画，素描；绘图
protective|保护的，防护的
ago|以前
signature|署名，签字，签名
primary|基本的；最初的
poem|诗，韵文，诗体文
hear|听见；听说；审讯
overall|工装裤 adj. 全面的
freely|自由地；直率地
creature|生物，动物
specify|详细说明；指定
combine|使结合；兼有
solar|太阳的，日光的
sort|种类；类别 v. 整理
dishonour|不光彩；丢脸的人
permit|允许 n. 执照
magnificent|壮丽的；华丽的
drift|漂流；漂泊 n. 趋势；流动
investigate|调查
proper|适合的；合乎体统的
lame|跛的；瘸的，残废的
mechanical|机械的；力学的
vital|生命的；有生命力的
clumsy|笨拙的；愚笨的
relieve|减轻；解除
describe|形容；描写，描绘
author|作者，作家
happy|快乐的；幸福的
glide|滑动 n. 滑行
drain|排去；放水 n. 耗竭
pen|钢笔，自来水笔
fatigue|疲劳，劳累
nonsense|胡说，废话
absolute|纯粹的；绝对的
sack|袋，麻袋；开除
apparatus|器械，仪器；器官
next|紧接的；贴近的
grace|优美；文雅；雅致
preface|序言，前言，引语
tone|音；腔调；声调
stove|炉头；炉子
identical|完全相同的；同一的
adjective|形容词
knee|膝，膝盖，膝关节
artist|艺术家，美术家
choke|使窒息；塞满
regardless|不顾一切地
reader|读者；读物，读本
horizontal|地平的；水平的
acceptable|可接受的，合意的
mail|邮件 v. 邮寄
cloud|云；云状物；阴影
busy|忙的；繁忙的
secretary|秘书；书记；大臣
deadly|致命的；死一般的
harbour|海港，港口 v. 庇护
bloom|花；开花，开花期
retain|保持，保留，保有
contest|争夺，争取；辩驳
output|产量；输出量；输出
railroad|铁路
institution|协会；制度，习俗
engine|发动机，引擎；机车
flesh|肉，肌肉；肉体
brother|兄弟；同事，同胞
inch|英寸
aeroplane|飞机
coffee|咖啡，咖啡茶
emit|散发；发射；发表
as|当…的时候
elementary|基本的；初级的
editor|编辑，编者，校订者
coin|硬币 v. 铸造（硬币）
definite|明确的；肯定的
skim|掠过，擦过；略读
tourist|旅游者，观光者
flourish|繁荣，茂盛，兴旺
taste|味觉；品味
ending|结尾，结局
confirm|证实；肯定；批准
nearly|差不多
away|离开，远离；…去
puzzle|难题；谜 v. 使迷惑
lawyer|律师；法学家
precision|精确，精密，精密度
debt|债，债务；欠债
promote|促进，发扬；提升
gasp|气喘，喘息
publish|出版；发表；公布
cubic|立方形的；立方的
smart|聪颖的，机灵的
floor|地板；楼层
dispute|争论，争执 n. 争论
blackboard|黑板
install|安装，设置
deceit|欺骗，欺诈
forecast|预测，预报 v. 预示
now|现在；立刻
believe|相信；认为
mile|英里
gap|缺口；间隔；差距
occur|发生；出现；存在
glove|手套
graduate|毕业生 v. 大学毕业
club|〔职业体育的〕俱乐部；俱乐部；夜总会
fierce|凶猛的；狂热的
dump|倾卸，倾倒；倾销
lag|落后；走得慢
hammer|锤，榔头 v. 锤击
congratulate|祝贺，向…道喜
storage|贮藏；贮藏量
guess|猜测，推测 n. 猜测，推测
desirable|值得相望的；可取的
critic|批评家；爱挑剔的人
bottom|底，底部，根基
bud|芽，萌芽；蓓蕾
australia|澳大利亚
resident|居住的 n. 居民
choose|选择，挑选；情愿
meanwhile|同时，当时
exclude|把…排除在外
convenience|便利，方便；厕所
rank|排，横行；社会阶层
nowadays|现今，现在
fall|落下；跌倒；陷落
furious|狂怒的；狂暴的
tap|轻叩 v. 轻叩
immediate|立即的；直接的
bruise|青肿，伤痕；擦伤
be|是；在
politics|政治，政纲；政治学
define|给…下定义；限定
heavily|重重地；大量地
pat|轻拍 n. 轻拍
dose|剂量，用量；一剂
operate|操作；施行手术
observe|看到；遵守；说
auxiliary|辅助的
proportion|部分；比，比率
record|记录；履历 v. 记录
groan|哼，呻吟 n. 呻吟
faith|信任，信心；信仰
meat|肉
harden|使变硬
particular|特定的；特殊的
arm|臂；臂状物；武器
lip|嘴唇
fable|寓言；虚构的故事
excuse|原谅；免除 n. 借口
discharge|释放；排出 n. 释放
cellar|地窑，地下室
noisy|喧闹的；嘈杂的
systematic|有系统的；有计划的
trail|小径；痕迹 v. 跟踪
her|（宾格）她 determiner.. 她的
rather|相当；宁可，宁愿
liquid|液体 adj. 液体的
indirect|间接的；不坦率的
meantime|其时，其间 adv. 当时
portion|一部分；一份
dinner|正餐，主餐；宴会
distribution|分发，分配；分布
african|非洲的 n. 非洲人
emphasize|强调，着重
kill|杀死；扼杀；消磨
cough|咳，咳嗽 n. 咳嗽
restraint|抑制；遏制；克制
composition|构成；作品；写作
porter|搬运工人
verify|证实，查证；证明
it|这，那，它
comb|梳子 v. 梳理
conquest|攻取，征服；克服
bristle|短而硬的毛；鬃毛
especially|尤其；特别，格外
absent|不在场的；缺乏的
bottle|瓶，酒瓶；一瓶
crush|压碎，碾碎；镇压
delegation|代表团
ourselves|我们自己
civilization|文明，文化；开化
objective|客观的；无偏见的
sulphur|硫（磺），硫黄
request|请求，要求 v. 请求，要求
talent|才能；天才；人才
physical|物质的；物理的
appliance|用具，器具，器械
inspection|检阅；检查，审查
bang|巨响，枪声；猛击
reflect|反射；反映；思考
happiness|幸福，幸运；快乐
attention|注意，留心；注意力
january|一月
venture|冒险 v. 敢于
input|输入；投入的资金
roar|吼叫；呼喊 n. 吼
faithful|忠诚的；如实的
monkey|猴子，猿
behalf|代表某人
operator|接线员；操作人员
humble|谦逊的；地位低下的
manufacturer|制造商；制造厂
mug|大杯
goat|山羊
democracy|民主制；民主
represent|代表；象征；描绘
accustom|使习惯
city|城市，都市
spoil|损坏，糟蹋；宠坏
packet|小包（裹），小捆
object|物，物体；目的
rate|比率；速度；价格
american|美洲的 n. 美国人
pull|拉，拖 n. 拉，拉力
mixture|混合；混合物
october|十月
pigeon|鸽子
conversely|相反地
multiply|乘；使增加
divorce|离婚，离异 v. 离婚
tray|托盘，碟；（浅）盘
contrast|对比，对照，悬殊
mad|发疯的；恼火的
sacrifice|牺牲；献祭 v. 牺牲；献祭
various|各种各样的，不同的
stuff|东西 v. 装，填，塞
rely|依赖，依靠；信赖
diameter|直径
boss|老板，上司 v. 指挥
dying|垂死的；临终的
indeed|确实；真正地
ignorant|不知道的；无知的
occasionally|偶然；非经常地
decent|体面的；正派的
human|人的，人类的 n. 人
glitter|闪闪发光 n. 闪光
receipt|收条，收据；收到
adventure|冒险；惊险活动
lover|情人；情侣；爱好者
infant|婴儿 adj. 婴儿的
muddy|多泥的，泥泞的
beast|兽，野兽
faint|微弱的；虚弱的
alarm|警报；惊恐，忧虑
convention|习俗，惯例；公约
durable|耐久的，耐用的
bed|床，床位；圃；河床
silent|寂静无声的；沉默的
dislike|不喜爱，厌恶 n. 不喜爱，厌恶
greatly|大大地，非常
quotation|引用；引文；报价单
pity|遗憾；怜悯 v. 同情
border|边，边缘；边界
panel|专门小组；面，板
wrap|裹，包，捆 n. 披肩
passage|通路，通道；通过
waken|醒来；弄醒
care|介意；关心 n. 小心
major|较大的 n. 专业
organic|有机体的；器官的
easy|容易的；安逸的
improve|改善；使更好
hi|嗨（表示问候等）
tissue|薄绢；薄纸；组织
vigorous|朝气蓬勃的
fancy|想象力；设想；爱好
income|收入；收益；进款
knot|（绳的）结；（树的）节
construction|建造；建筑；建筑物
inquire|打听，询问；调查
spark|火花，火星
aside|在旁边，到旁边
stripe|条纹，条子
meter|计量器；计，表
frequent|时常发生的；经常的
pure|纯粹的；纯洁的
beyond|在…的那边
eager|渴望的，热切的
fox|狐狸；狡猾的人
penny|（英）便士；（美）分
infer|推论，推断；猜想
steam|蒸汽 v. 蒸发；蒸
file|档案 v. 把…归档
midnight|午夜，子夜，夜半
scientific|科学（上）的
oil|油；石油 v. 加油于
instruct|指示；教；通知
protest|抗议 v. 抗议
cancer|癌，癌症，肿瘤
instantly|立即，即刻
chinese|中国的 n. 中国人
remedy|治疗；补救 v. 治疗；补救
good|好的；有本事的
method|方法，办法；教学法
monthly|每月的 adv. 每月
dream|梦；梦想 v. 做梦
load|装；装满 n. 负载
fuel|燃料 v. 给…加燃料
modern|现代的，近代的
common|普通的；共同的
recommend|劝告；推荐，介绍
produce|产生；生产；展现
definition|定义，释义；定界
castle|城堡；巨大建筑物
supreme|最高的；最大的
ask|问；要求；邀请
dumb|哑的；无言的
pin|针，饰针 v. 别住
attain|获得；达到
curtain|帘，窗帘；幕（布）
raise|举起；引起；提高
fog|雾；烟雾，尘雾
rotten|腐烂的，发臭的
mysterious|神秘的；难以理解的
diary|日记，日记簿
survive|幸免于；活下来
bicycle|自行车，脚踏车
sausage|香肠，腊肠
attack|攻击，进攻 n. 攻击，进攻
saw|锯子 v. 锯，锯开
indication|指示；表示；表明
attempt|尝试，试图 n. 企图
submarine|水下的 n. 潜水艇
revolution|革命；旋转，绕转
overseas|海外 adj. 在海外的
oriental|东方的；东方国家的
for|给；为；因为
manufacture|制造 n. 制造；产品
healthy|健康的；有益健康的
multiple|多的；多种的
cock|公鸡；雄禽；旋塞
actress|女演员
strap|带子 v. 捆扎
economic|经济的，经济学的
solution|解决，解答；溶解
barrel|桶；圆筒；枪管
hand|手；指针
partly|部分地，不完全地
paw|脚爪，爪子
upset|弄翻，打翻，倾覆
plunge|使投入；使陷入
injury|损害，伤害；受伤处
hopeless|没有希望的；绝望的
escape|逃跑；逸出 n. 逃跑
philosophy|哲学；哲理；人生观
thrive|兴旺，繁荣，旺盛
fireman|消防队员
awfully|令人畏惧的；很
golden|金色的；极好的
technical|技术的，工艺的
carrot|胡萝卜
concerning|关于
lot|. 许多，大量 n. 抽签，抓阄
unlikely|未必的，未必可能的
liar|说谎的人
family|家，家庭；家族
hay|干草
stress|压力；重音 v. 着重
many|. 许多的 pron. 许多人
goal|目的；球门；得分
indefinite|不明确的；不定的
inner|内部的；内心的
bear|熊；粗鲁的人
pretty|漂亮的，标致的
therefore|因此，所以
goose|鹅；雌鹅
afford|担负得起…；提供
pupil|学生，小学生
dairy|牛奶场 adj. 乳制品
boundary|分界线，边界
afterward|后来，以后
fan|（运动等）狂热爱好者
election|选举；当选
wheat|小麦
plant|植物；工厂 v. 栽种
page|页
spite|3、释义:n. 不顾；恶意，怨恨 v. 刁难，欺侮
relationship|关系；联系
grape|葡萄；葡萄藤
restrain|抑制，遏制；限制
dimension|尺寸，尺度；面积
saucer|茶托，浅碟
observer|观察员，观测者
hero|英雄；勇士；男主角
happen|发生；碰巧，恰好
kick|踢 n. 踢
jet|喷气式飞机；喷嘴
chemistry|化学
interaction|相互作用；干扰
evil|祸害；邪恶 adj. 坏的
sponsor|发起者 v. 发起
gown|长袍，长外衣
shot|发射；弹丸；射门
gay|快乐的；鲜明的
obstacle|障碍，妨害；障碍物
sometime|在某一时候；从前
satisfactory|令人满意的，良好的
particularly|特别，尤其，格外
distribute|分发，分送；分布
reason|理由；理性 v. 推理
cross|穿过；使交叉
development|发展；生长；开发
sour|酸的；脾气坏的
disadvantage|不利，不利地位
flush|（脸）发红
minor|较小的；较次要的
canvas|粗帆布；一块油画布
medical|医学的；内科的
economical|节约的；经济的
could|能，会，可以（can的过去式）
oppress|压迫，压制；压抑
acute|敏锐的
latin|拉丁的 n. 拉丁语
rough|表面不平的；粗略的
merchant|商人；零售商
other|另外的；其余的
progressive|进步的；向前进的
heal|治愈；使和解
competition|竞争；比赛
court|法院，法庭；庭院
drink|饮 n. 饮料
ball|球；球状物；舞会
organize|组织；编组
remain|剩下，余留；保持
chart|图，图表；海图
interference|干涉，干预；阻碍
dock|船坞；码头
anchor|锚 v. 抛锚，停泊
breast|乳房；胸脯，胸膛
glance|看一下 n. 一瞥
announce|宣布，宣告，发表
join|参加；连接
poor|贫穷的；贫乏的
reference|参考；提及
delete|删除；擦掉
digest|消化；领会 n. 文摘
great|大的；伟大的
nut|坚果，干果；螺母
gun|枪，炮，手枪
urge|催促；推进 n. 冲动
but|但是，可是
ought|应当，应该
impossible|不可能的，办不到的
real|真的；现实的
score|得分，比数；成绩
devise|设计，发明
equipment|装备，设备；配备
luck|好运，幸运；运气
absolutely|完全地；绝对地
queue|行列 v. 排队等候
rural|农村的，田园的
office|办公室；处，局，社
sore|痛的；恼火的 n. 疮
confuse|使混乱，混淆
neighbourhood|附近地区（的居民）；邻近
japanese|日本的 n. 日本人
fulfil|履行；满足；完成
chocolate|巧克力；巧克力糖
chicken|鸡；鸡肉
limited|有限的
kilometre|千米，公里
separate|分离的；个别的
campus|校园，学校场地
blanket|毛毯，毯子，羊毛毯
frequently|时常，常常
thermometer|温度计，寒暑表
undoubtedly|无容置疑，肯定地
market|市场；集市；销路
big|大的，巨大的
half|半，一半 adj. 一半的
blade|刀刃，刀片；叶片
afraid|害怕的；担心的
cinema|电影院；电影，影片
stiff|硬的；僵直的
librarian|图书馆馆长
lamp|灯
hostile|不友善的；敌方的
line|线；线条；排；路线
extensive|广阔的；广泛的
bet|打赌 n. 打赌
prove|证明；结果是
sway|摇动
locomotive|火车头，机车
along|沿着 adv. 向前
oven|炉，灶；烘箱
bury|埋葬，葬；埋藏
arrow|箭；箭状物；〔指示方向的〕箭号，箭头（符号）
green|绿色的 n. 绿色
logic|逻辑，推理；逻辑性
fluid|流体，液体
press|压，按；按，揿；催促
firm|商行，商号，公司
funeral|葬礼，丧礼，丧葬
compile|编辑，编制，搜集
grey|灰色的 n. 灰色
claw|爪，脚爪，螯
fluent|流利的，流畅的
prominent|突出的；凸起的
bitterly|苦苦地；悲痛地
dissatisfy|使不满，使不平
embrace|拥抱；包括
defence|防御；防务；辩护
trade|贸易；职业 v. 交易
owe|欠；应把…归功于
gray|灰色的 n. 灰色
digital|数字的，计数的
gradually|逐渐地，逐步地
ax|斧子
estimate|估计，评价 n. 估计
avoid|避免；躲开
acceleration|加速；加速度
also|而且，还；亦，也
subway|地道；地下铁路
circumference|圆周，周长，圆周线
seek|寻找，探索；试图
require|需要；要求，命令
bounce|反跳，弹起；跳起
minister|部长，大臣；公使
miracle|奇迹，令人惊奇的人
clothe|给…穿衣服
newly|新近，最近
confidence|信任；信赖；信心
lack|缺乏，不足 v. 缺乏，不足
bureau|局，司，处；社，所
detection|察觉，发觉；侦察
jury|陪审团；评奖团
difference|差别；差；分歧
hope|希望 n. 希望
grant|授给物 v. 授予
insufficient|不足的；不适当的
cheerful|快乐的，愉快的
committee|委员会；全体委员
east|东；东部 adv. 在东方
pronunciation|发音，发音法
photo|照片，相片
occupation|职业；占领，占据
document|公文，文件；证件
popular|流行的；民众的
resume|重新开始；恢复
eyesight|视力，目力
canal|运河；沟渠；管
obviously|明显地，显然地
please|使高兴，请满意
breeze|微风，和风
mechanic|技工，机械，机修工
beside|在…旁边
lid|盖子，盖，囊盖
percent|百分之…
englishman|英国男子
mature|成熟的 v. 使成熟
basketball|篮球运动；篮球
orbit|运行轨道 v. 环绕
govern|统治，治理；支配
expose|使暴露；揭露
nod|点（头）；点头表示
ash|灰，灰末；骨灰
privilege|特权，优惠
grocer|食品商；杂货商
numerous|为数众多的；许多
swift|快的；反应快的
arise|出现；由…引起
foremost|最初的；第一流的
wage|开展（运动）
implication|含义，暗示，暗指
childish|孩子的；幼稚的
name|名字；名誉 v. 说出
prefer|更喜欢
exact|确切的；精确的
often|经常，常常
residence|居住；驻扎；住处
flood|洪水 v. 淹没
generation|一代，一代人；产生
permanent|永久的；持久的
genius|天才，天赋，天资
desert|沙漠 v. 离弃；擅离
nerve|神经；勇敢，胆量
northern|北方的，北部的
specialize|成为…专家；专攻
emergency|紧急情况，突然事件
hen|母鸡；雌禽
act|行动；见效 n. 行为
one|一 pron. 一个人
argument|争论，辩论；理由
painter|画家，绘画者；漆工
division|分，分配；除法
burst|使爆裂 n. 爆炸
closely|紧密地；接近地
church|教堂，礼拜堂；教会
track|行踪；路径；轨道
chase|追逐，追赶；追求
note|笔记；便条；注释
attract|吸引；引起……的兴趣；诱惑
both|两者（都）
brilliant|光辉的；卓越的
consume|消耗，消费；消灭
axis|轴，轴线；中心线
plastic|可塑的 n. 塑料
relation|关系，联系；家属
succession|连续；继任，继承
weaken|削弱
officer|官员；干事；军官
keep|保持；坚持
electronics|电子学
optimistic|乐观的；乐观主义的
permission|允许，许可，同意
brick|砖，砖块；砖状物
loose|松的；宽松的
welfare|幸福；福利
paper|纸；官方文件；文章
former|在前的 n. 前者
truth|事实；真理；真实性
impose|把…强加；征（税）
neglect|疏忽；忽视，忽略
harm|伤害，损害 v. 损害
pie|（西点）馅饼
pioneer|拓荒者；先驱者
mystery|神秘；神秘的事物
determination|决心；决定；确定
reply|回答，答复 n. 回答，答复
department|部，司，局，处，系
cake|饼，糕，蛋糕
parcel|包裹，小包，邮包
status|地位，身分
edge|边缘，边；刀口
refusal|拒绝
kettle|水壶；锅
positive|积极的；确定的
gaze|凝视，盯，注视
close|关，闭；结束
presence|出席，到场；在
production|生产；总产量
foolish|愚蠢的；鲁莽的
found|创立，创办；建立
whisper|低声地讲
gather|聚集；集合；收集
captive|俘虏，被监禁的人
colonel|陆军上校；中校
hateful|可恨的，可恶的
routine|例行公事 adj. 日常的
mess|混乱，混杂，肮脏
pronounce|发…的音；宣布
correspond|相符合；相当
blank|空白的 n. 空白
consequence|结果，后果
hello|喂
slit|裂缝 v. 切开，撕开
chalk|白垩；粉笔
midday|正午，中午
despise|鄙视，蔑视
humour|幽默，诙谐，幽默感
volt|伏特，伏
roller|滚筒，滚轴；滚柱
navigation|航行；航海术
establishment|建立，设立，确立
needle|针；编织针
torch|手电筒；火炬，火把
another|再一个的；别的
bubble|泡 v. 冒泡，沸腾
vary|改变；使多样化
finger|手指；指状物
charming|迷人的，可爱的
abstract|抽象的 n. 摘要
endless|无止境的
fast|快的；偏快的 adv. 快
painful|使痛的；费力的
import|输入，进口 v. 输入，进口
additional|附加的，追加的
die|死，死亡；灭亡
abnormal|不正常的；变态的
peasant|农民
hydrogen|氢
heel|脚后跟，踵；中文释义: 后跟
base|基础，底层；基地
uncover|揭开…的盖子
interior|内的；内地的内部 n. 内部
chain|链，链条
slippery|滑的，使人滑跤的
historical|历史的，有关历史的
mechanically|机械地
myself|我自己；我亲自
signal|信号 v. 发信号
thoughtful|体贴的；沉思的
discipline|纪律；训练 v. 训练
draft|草稿；汇票 v. 起草
performance|演出；表现；履行
workshop|车间，工场；创作室
listener|听众之一；听者
paint|（给…）上油漆；画，绘画
generate|发生；引起
resist|抵制；抵抗
sensitive|敏感的；灵敏的
perform|演出；履行，执行
fertilizer|肥料
reinforce|加强；增援，支援
recognize|认识，认出；承认
okay|对，好
police|警察；警察当局
forth|向前；向外，往外
reproduce|繁殖，生殖
framework|框架，构架，结构
gracious|有礼貌的；仁慈的
screw|螺旋，螺丝 v. 拧紧
pause|中止，暂停 v. 中止，暂停
cheese|奶酪，干酪
sleeve|袖子，袖套
donkey|驴
vacant|空的；未被占用的
expense|花费，消费；费用
lead|铅，铅制品
friendship|友谊；友好
bare|赤裸的；仅仅的
athlete|运动员；田径运动员
regarding|关于
commonly|普通地，一般地
magic|魔法，巫术；戏法
cook|烹调，煮；烧菜
intend|想要，打算；意指
powder|粉末；药粉；火药
pitch|沥青
ninth|第九 n. 九分之一
filter|过滤 n. 过滤器
deal|买卖；待遇
collect|收集；收款
conjunction|接合，连接；连接词
bond|债券，公债；联结，联系
jail|监狱 v. 监禁
arrangement|安排；整理，排列
competent|有能力的
section|切片；一段；部分，部门
confusion|混乱；骚乱；混淆
mercy|仁慈，慈悲，恩惠
successive|连续的；接连的
pour|灌，倒；倾泻
couple|夫妇；（一）对；几个
mention|提及，说起 n. 提及，说起
stake|赌金；桩；奖品
decide|决定，决心；解决
conscious|意识到的；有意的
companion|同伴；共事者；伴侣
football|足球
careful|仔细的；细致的
receive|得到；收到；接待
nowhere|任何地方都不
settle|安排；安放；调停
sign|符号；招牌 v. 签名
hide|把…藏起来；隐瞒
architecture|建筑式样；建筑学
daylight|白昼，日光；黎明
entitle|给…权利（或资格）
legend|传说，传奇
appropriate|适当的，恰当的
crust|面包皮；硬外皮
existence|存在，实在；生活
territory|领土，版图；领域
outlet|出口；出路；排遣
compare|比较，对照；比作
emotional|感情的，情绪的
subtract|减，减去，去掉
italian|意大利的 n. 意大利人
density|密集，稠密；密度；〔物质的〕密度
drunk|醉的；陶醉的
magazine|杂志，期刊
patience|忍耐，容忍，耐心
direction|方向，方位；指导
job|职业；工作；零活
practise|练习，实习，训练
slope|倾斜；斜面 v. 倾斜
ankle|踝，踝节部
dead|死的，无生命的
sphere|球，圆体；范围
me|（宾格）我
develop|发展；形成；开发
immense|巨大的；极好的
rabbit|兔子
outset|开始，开端
disguise|隐瞒，掩埋 n. 假装
brisk|活泼的；清新的
keyboard|键盘
onion|洋葱，洋葱头
energy|活力；精力；能；能量
shriek|尖声喊叫 n. 尖叫声
elaborate|复杂的；精心制作的
horse|马；马科动物
requirement|需要；要求
grain|谷物，谷粒；颗粒
moment|时刻；片刻，瞬间
occurrence|发生，出现；事件
deed|行为；功绩；劣迹；契约
owl|猫头鹰，枭
isolate|使隔离，使孤立
collection|收藏品；搜集，收集
container|容器；集装箱
knife|小刀，刀，餐刀
ignore|不顾，不理，忽视
sufficient|足够的，充分的
proposal|提议，建议；求婚
milk|乳，牛奶 v. 挤（奶）
exercise|锻炼；训练 v. 练习
shortly|立刻；简短地
retire|退休；退职；就寝
communist|共产党员
supplement|增补物，补充物 v. 增补，补充
betray|背叛；辜负；泄漏
meal|膳食，一餐
august|八月
during|在…期间
brief|短暂的；简短的
astonish|使惊讶，使吃惊
security|安全工作；安全；安全感
tremble|发抖，哆嗦；摇动
inferior|下等的；劣等的
marble|大理石
inventor|发明者；发明家
metal|金属，金属制品
efficiency|效率；效能；功效
high|高的；高级的 adv. 高
born|天生的；出生的
destroy|破坏；消灭；打破
heating|加热，供暖
comprise|包含，包括；构成
ease|容易；舒适 v. 缓和
liberation|解放
wholly|完全地，全部
split|被劈开；劈开
basin|洗脸盆；盆；盆地
weed|杂草，野草 v. 除草
calm|静的，平静的
sweater|厚运动衫，毛线衫
shear|剪；剥夺
swallow|燕子
greet|问候，招呼；反应
practical|实践的；实用的
basically|基本上
conductor|售票员；（乐队）指挥
naturally|自然地；天然地
undertake|从事；承担；保证
despair|绝望 v. 绝望
nose|鼻子
morning|早晨，上午
mild|温柔的；和缓的
interrupt|打断，打扰；中止
period|时期；学时；句号
loaf|一条面包，一个面包
resistance|抵抗；抵制；抵抗力
enforce|实施，执行；强制
definitely|一定地，明确地
flow|流动；飘垂；涨潮
grow|增长；生长
federal|联邦的；联盟的
agent|代理人，代理商
lively|活泼的
utility|效用，有用，实用
establish|建立，设立；确立
distinct|与其它不同的
interval|间隔；休息；间距
motor|发动机；机动车
brute|禽兽，畜生
account|记述；解释；账目
gramme|克（重量单位）
absence|缺席，不在场；缺乏
operation|手术；操作；运算
crash|碰撞，坠落 n. 碰撞
beef|牛肉；菜牛
heap|（一）堆；大量
deposit|使沉淀；存放
displease|使不愉快，使生气
appoint|任命，委任；约定
bound|一定的；有义务的
merely|仅仅，只不过
besides|adv,prep. 而且；除…之外
park|公园；停车场
nineteen|十九，十九个
depress|使沮丧；按下
cry|哭，哭泣；叫喊
into|进，入；进入到
maths|（英）数学
significance|意义，意味；重要性
bag|袋，包，钱包，背包
crack|裂缝，裂纹 v. 爆裂
certainty|必然；肯定
lazy|懒惰的，懒散的
effect|结果；效果，效力
hurt|使受伤；使痛心
block|街区 v. 堵塞，拦阻
hillside|（小山）山腰，山坡
specialist|专家
worm|虫，蠕虫
dictionary|词典，字典
cabbage|洋白菜，卷心菜
date|日期 v. 注…日期
warmth|暖和，温暖；热烈
latter|（两者中）后者的
indoors|在室内，在屋里
helicopter|直升机
leg|腿，腿部
quality|质量；品质；特性
command|命令；指挥；控制
preference|偏爱；优先；优先权
actually|实际上；竟然
secondary|第二的；次要的
academy|专科院校；私立中学
report|报告；汇报
magnet|磁铁，磁石，磁体
none|没有人；没有一点 adv. 毫不
large|大的；巨大的
corporation|公司，企业；社团
thorough|彻底的；详尽的
chin|颏，下巴
nearby|附近的 adv. 在附近
react|作出反应；有影响
map|地图；图；天体图
vinegar|醋
article|文章；物品；条款
angle|角，角度
zone|地区，区域，范围
rail|横条，横杆；铁轨
holy|神圣的；圣洁的
copy|抄件 v. 抄写，复制
elephant|象
hasten|催促；赶紧
helpless|无助的；无能的
mutter|轻声低语；抱怨
musical|音乐的
silk|蚕丝，丝，丝织品
agency|经办；代理；代理处
conflict|争论；冲突；斗争
anything|任何事物；一切
outskirt|外边，郊区
peculiar|特有的；特别的
index|索引；指数；指标
anxious|忧虑的；渴望的
likely|可能的 adv. 很可能
mat|席子；草席；垫子
cushion|垫子，坐垫，靠垫
flock|羊群，群；大量
mislead|将…引入歧途，误导
vague|模糊的；含糊的
generator|发电机；发生者
concrete|混凝土；具体物
scatter|撒；散播；使消散
brake|闸，刹车 v. 制动
brain|脑，脑髓；脑力
commander|司令官，指挥员
arrest|逮捕，拘留；阻止
limb|肢，臂，翼；树枝
highway|公路；大路
quite|完全；相当；的确
disposal|丢掉，处理，销毁
analyse|分析，分解，解析
flight|航班；飞行；逃跑
consistent|坚持的，一贯的
repetition|重复，反复
inform|通知，向…报告
flat|平的，扁平的
idea|想法；思想；意见
blue|蓝色的 n. 蓝色
married|已婚的；婚姻的
kitchen|厨房，灶间
bridge|桥，桥梁；桥牌
spare|抽出；拨出；留出；匀出 adj. 多余的
deepen|加深；深化
anyone|任何人
envelope|信封；封套；封皮
glare|瞪眼 n. 瞪眼
fault|缺点；过失；故障
calculation|计算，计算结果
driver|驾驶员，司机
airport|机场，航空站
intermediate|中级的；中间的
location|位置，场所
unlike|不同的 prep. 不象…
detect|察觉，发觉；侦察
fresh|新的；新鲜的
chance|机会，机遇；可能性
cement|水泥；胶泥 v. 粘结
release|释放；放松；发表
extra|额外的 adv. 特别地
drill|钻头；操练 v. 钻孔
accessary|同谋，从犯
dwelling|住处，寓所
hardly|几乎不，简直不
dance|跳舞；摇晃 n. 舞
atomic|原子的；原子能的
omit|省略，省去；遗漏
neck|颈，脖子
lady|女士，夫人；贵妇人
announcer|播音员
engineering|工程；工程学
formula|公式，式
law|法律；法令；法则
lieutenant|陆军中尉；副职官员
dependent|依靠的，依赖的
utmost|最大的 n. 极限
begin|开始
cooperate|合作，协作；配合
rush|冲，奔；催促
grieve|悲痛；使悲痛
gymnasium|体育馆，健身房
brim|边，边缘；帽沿
variety|多样化；种类；变种
construct|建造；建设；构筑
ant|蚂蚁
lovely|可爱的；令人愉快的
principle|原则，原理
shelter|隐蔽处；掩蔽，庇护
uniform|一样的 n. 制服
promise|诺言 v. 允诺
handkerchief|手帕
international|国际的，世界（性）的
shade|荫；遮光物 v. 荫蔽
country|国家，国土；农村
punctual|严守时刻的；准时的
bend|使弯曲；弯曲
diligent|勤勉的，勤奋的
learned|有学问的；学术上的
prescribe|开处（方）；命令
gum|口香糖；树胶
lock|锁 v. 锁上，锁住
relativity|相对性；相对论
moon|月球，月亮；卫星
internal|国内的；内的
tale|故事；传说
accent|口音，腔调；重音
say|比如说[用于举例]
brandy|白兰地酒
meaning|意义，意思；意图
peaceful|安静的；和平的
bomb|炸弹 v. 轰炸
fry|油煎，油炸，油炒
lessen|减少，减轻；缩小
finance|财政，金融；财源
maintenance|维修；维持，保持
squeeze|压；挤；捏；榨；压榨
hill|小山，山岗；丘陵
tense|时态，时
fare|车费，船费，票价
tend|照管，照料，护理
passion|强烈的情感，激情；强烈的爱好，热爱
brand|品牌；烙印 v. 铭刻
temptation|诱惑，引诱
correction|改正，纠正，修改
cease|停止，停息 n. 停止，停息
shed|流出；散发；脱落
america|美洲；美国
directly|直接地；立即
camera|照相机，摄影机
analysis|分析，分解，解析
intentional|故意的，有意识的
jazz|爵士音乐，爵士舞曲
unity|单一；统一；团结
trial|审判；试，试验
beggar|乞丐，穷人
amongst|在…之中（among）
colony|殖民地；侨居地
north|北，北方 adj. 北方的
synthetic|综合的；合成的
strain|拉紧；尽力
funny|滑稽的；古怪的
camp|野营，营地，兵营
circuit|环行；电路
arrange|筹备；整理
button|扣子；按钮 v. 扣紧
classical|古典的；经典的
consequently|因此，因而，所以
reservoir|水库；蓄水池
vision|视力；想象力；梦幻
friday|星期五
headline|大字标题；新闻提要
product|产品；产物；（乘）积
flexible|易弯曲的；灵活的
ridge|岭，山脉；脊；垄
objection|反对，异议；不喜欢
bucket|水桶；吊桶；铲斗
need|需要
exceed|超过，胜过；超出
official|官员的；官方的
obvious|明显的，显而易见的
leave|离去
wrist|腕，腕关节
hence|因此，所以；今后；今后
journalist|记者，新闻工作者
profit|利润；益处 v. 得益
compel|强迫，迫使屈服
marine|海的；海上的
cable|缆，索；电缆；电报
key|钥匙；键；答案
rear|后部，后面；背面
birth|分娩，出生；出身
much|非常，很 det. 许多的
pardon|原谅；赦免 v. 原谅
phrase|短语；习惯用语
pan|平底锅；烤盘
jewel|宝石；宝石饰物
similar|相似的，类似的
sword|剑，刀
wander|漫游；迷路；离题
frighten|使惊恐，吓唬
citizen|公民；市民，居民
i|（主格）我
weakness|弱点；虚弱；软弱
exchange|交换；交流 n. 交换
witness|证据；证人 v. 目击
japan|日本，日本国
picture|画，图片 v. 画
cabin|小屋；船舱；机舱
minute|分，分钟；一会儿
achieve|完成，实现；达到
characteristic|特有的 n. 特性
semiconductor|半导体
minus|负面的；使显得有缺陷的 prep. 减（去）
silly|傻的，愚蠢的
hungry|饥饿的；渴望的
odd|奇数的；单只的
traffic|交通，通行；交通量
unconscious|不省人事的
reading|读书；读，阅读
carbon|碳
senate|参议院，上院
physician|医生，内科医生
proportional|比例的；相称的
pace|步，步速 v. 踱步
harness|控制[利用]〔自然力等〕 n. 马具，挽具
suspect|怀疑；疑心
license|许可；执照 v. 准许
little|小的；少；幼小的
accelerate|（使）加快；促进
steep|险峻的，陡峭的
africa|非洲
organism|生物体；有机体
county|英国的郡，美国的县
globe|地球，世界；地球仪
food|食物，食品；养料，精神食粮
machine|机器；机械
bore|使厌烦；钻，挖
measure|量，测量 n. 掂出某人的分量
reform|改革，改良 n. 改革，改良
radius|半径
fist|拳（头）
nuisance|讨厌的人（东西）
distinction|差别，不同，区分
mosquito|蚊子
typewriter|打字机
accordance|按照某事物
plus|加，加上 adj. 正的
policeman|警察
christmas|圣诞节
interest|兴趣；利益；利息
greenhouse|温室，玻璃暖房
farewell|再会 n. 告别
him|（宾格）他
shelf|搁板，架子
later|后来；过一会儿
fashion|风尚；方式
daily|每日的 n. 日报
outside|外部；外表 adj. 外部的
principal|主要的 n. 负责人
mine|我的
farmer|农民，农夫；农场主
alter|改变，变更；改做
asia|亚洲
twist|捻；拧 n. 扭弯
playground|操场，运动场
guidance|引导，指导，领导
evaporate|使蒸发
upright|垂直的；正直的
honour|光荣；尊敬，敬意
rescue|营救，解救，救援 n. 营救，解救，救援
evolution|进化，演化；发展
stocking|长（筒）袜
instrument|工具；仪器；乐器
nice|美好的，令人愉快的
faculty|系，科；才能，能力
auto|（口语）汽车
phone|电话，电话机
preserve|保护；保存；腌渍
undo|解开，打开；取消
liver|肝；肝脏
distance|距离，间距；远处
due|预期的；应给的
cat|猫，；猫科动物
capacity|容量；能力
offer|提供；提出 n. 提供
conference|会议，讨论会
embarrass|使窘迫，使为难
body|身体；尸体；主体
holiday|假期；假日，节日
glass|玻璃；玻璃杯
royal|王的；皇家的
wave|波；波涛 v. 波动，挥动，摆动
different|差异的；各种的
cut|切，割，剪；减少
praise|赞扬，赞美 v. 赞扬
monitor|班长；监视器
dawn|黎明；开端 v. 破晓
oar|浆，橹
kneel|跪，跪下，跪着
ordinary|平常的；平凡的
postage|邮费，邮资
component|组成部分；成分；组件
hit|打；碰撞 n. 击
cheer|使振作；欢呼
pass|经过；通过；度过
level|水平面 adj. 水平的
anywhere|在什么地方
affect|影响；感动
deer|鹿
every|每一的；每隔…的
a|一（个）；每一（个）
bar|酒吧间；条，杆；栅
plenty|丰富，充足，大量
baggage|行李
pint|品脱
reserve|预定；储备，保留
fly|蝇，苍蝇 v. 飞行
friend|朋友，友人
any|什么，一些；任何的
expand|扩大；使膨胀
nurse|护士；保姆 v. 看护
toilet|厕所，盥洗室，浴室
creep|爬行；缓慢地行进
prompt|及时的 v. 敦促
goods|货物；商品
career|生涯，职业；经历
museum|博物馆；展览馆
coast|海岸，海滨（地区）
diamond|金钢石，钻石；菱形
increasingly|日益，越来越多地
spill|使溢出
comprehension|理解，理解力；领悟
consciousness|意识，觉悟；知觉
chest|胸腔，胸膛；箱子
otherwise|否则；要不然
movement|动作，活动；移动
bowl|碗，钵；碗状物
bat|球拍；蝙蝠
somewhat|有点
ancestor|祖宗，祖先
liberal|心胸宽大的；慷慨的
far|远的 adv. 远，遥远
battle|战役；斗争 v. 作战
tropical|热带的
molecule|分子，克分子
general|总的；一般的 n. 将军
gentle|和蔼的；轻柔的
motion|运动；手势；提议
however|然而；不管怎样
float|漂浮；使漂浮
adjust|调整，调节
drama|戏剧
circular|圆的；循环的
financial|财政的，金融的
above|在…上面；高于
enthusiastic|热情的，热心的
landlord|地主；房东；店主
volcano|火山
convey|传送；运送
hard|硬的；困难的
microphone|话筒，麦克风
proud|骄傲的；自负的〔含贬义〕；自豪的
gently|有礼貌地；柔和地
curl|卷毛；螺旋 v. 卷曲
gloomy|黑暗的；令人沮丧的
flavour|味，味道；风味
loud|响亮的；吵闹的
manner|方式；态度；礼貌
psychological|心理的，心理学的
passive|被动的；消极的
tender|嫩的；脆弱的
dry|干的，干燥的
mute|缄默的 n. 哑巴
dorm|宿舍
discard|丢弃，抛弃，遗弃
change|改变，变化；零钱
outstanding|突出的，杰出的
distress|忧虑，悲伤
wear|磨损
relate|使联系；叙述
undergo|经历，经受，忍受
radioactive|放射性的
geography|地理，地理学
his|他的，他的东西
probable|很可能的；大概的
aware|知道的，意识到的
central|中心的；主要的
ownership|所有（权），所有制
household|家庭，户；家务
site|地点，地基；场所
nine|九，九个
voyage|航海，航空 v. 航海，航行
expensive|昂贵的，花钱多的
provide|提供；装备，供给
before|在…以前
empty|空的；空洞的
heat|热；炎热 v. 变热
professional|职业的 n. 专业人员
canadian|加拿大的
beam|梁；横梁；束，柱
last|最后的 adv. 最后
cause|原因；理由；事业
reluctant|不愿的，勉强的
exclaim|呼喊；惊叫
breed|品种 v. 使繁殖
keeper|饲养员；看护人
mouth|嘴，口，口腔
camel|骆驼
hell|地狱；极大的痛苦
fourth|第四 n. 四分之一
march|三月
entrance|入口，门口；进入
essential|必要的；本质的
consider|考虑；认为；关心
compress|压紧，压缩
brow|额；眉，眉毛
sound|健康的；完好的
recall|回想；叫回；收回
scarcely|几乎不；仅仅
secure|安心的；安全的
mayor|市长
most|det,pron. 最多的 adv. 最，很
connection|连接，联系
nature|大自然；本性；性质
alone|单独的 adv. 单独地
marvellous|奇迹般的；了不起的
hold|拿住；掌握；拥有
like|喜欢；喜爱；希望
treat|对待；处理 n. 款待
beg|乞求；请求
footstep|脚步；脚步声；足迹
himself|他自己；他亲自
cure|医治；消除 n. 治愈
bough|树枝
bee|蜂，密蜂；忙碌的人
treaty|条约；协议，协定
bird|鸟，禽
butterfly|蝴蝶
insert|插入；嵌入；登载
phase|阶段；相位
irregular|不规则的；不整齐的
necessarily|必然，必定
cloth|布；衣料；桌布
door|门；通道；一家
description|描写，形容；种类
marry|结婚；娶，嫁
beat|打，敲；打败
community|社区；社会；公社
swing|摇摆；回转 n. 摇摆
branch|树枝；分部；分科
stimulate|刺激；激励，激发
uneasy|心神不安的，忧虑的
solemn|严肃的，庄重的；庄严的；隆重的
sew|缝制，缝纫
astronaut|宇宙航行员，宇航员
memorial|纪念的；记忆的
dispose|去掉，丢掉；销毁
brighten|使发光；使快活
addition|附加物；加，加法
sulfur|硫（磺），硫黄
beginner|初学者，生手
impress|给…深刻印象
print|印刷 n. 印刷的文字
fit|适合；安装
lay|置放；铺设；设置
pollute|弄脏，污染，沾污
experimental|实验的，试验的
attach|缚，系，贴；附加
focus|聚焦；注视 n. 焦点
hunt|打猎；搜寻 v. 追猎
cruel|残忍的，残酷的
desk|书桌，办公桌
cost|价格；代价；成本
slam|使劲关；砰地放下
decay|腐烂；衰败 n. 腐烂
opera|歌剧
towel|毛巾，手巾
crowd|人群；一伙人；大众
decade|十年，十年期
introduction|介绍；引进；引言
car|汽车，小汽车，轿车
prime|首要的 n. 青春
ache|痛 n. 疼痛
grand|宏伟的；重大的
earn|赚得，挣得；获得
goodness|优良，德性，仁慈
gunpowder|黑色火药；有烟火药
spray|浪花；喷雾 v. 喷
guide|导游者 v. 给某人领路，带领
pile|堆 v. 堆叠，累积
bless|为…祝福
row|（一）排，（一）行
trick|诡计；窍门 v. 哄骗
february|二月
cell|细胞；小房间
completely|十分，完全地
overtake|追上，赶上
extend|延长；扩大
pair|一对 v. 成对，配对
policy|政策，方针
sympathetic|同情的
mass|团；众多；群众
desperate|拼死的；绝望的
initial|最初的
red|红色的 n. 红色
award|奖，奖品
dig|掘，挖；采掘
electron|电子
comfortable|舒适的
association|协会，团体；联合
labour|劳动；工作；劳工
diagram|图解，图表，简图
scheme|计划，规划；诡计
accustomed|惯常的；习惯的
substantial|坚固的
awake|醒着的 v. 唤醒
entry|入口处；登记；进入
assistant|助手，助理；助教
pocket|衣袋 adj. 袖珍的
code|准则；法典；代码
lime|石灰
drum|鼓；鼓状物；圆桶
singular|单数的；非凡的
aim|瞄准；针对；致力
counter|柜台；计数器
because|由于，因为
religious|宗教的；虔诚的
persuade|说服
consumption|消耗量；消耗
harmony|调合，协调，和谐
improvement|改进，改善；改进之处
dial|钟面；拨号盘 v. 拨
efficient|效率高的，有能力的
loudspeaker|扬声器，喇叭
typist|打字员
accumulate|积累；堆积
grasp|抓紧；掌握 n. 抓
picnic|郊游，野餐 v. 野餐
crisis|危机；存亡之际
underneath|prep,adv. 在下面，在底下
contain|包含，容纳
go|去；走；变为
loyalty|忠诚；忠心
amaze|使惊奇，使惊愕
copper|铜；铜币
delivery|投递；交付；分娩
institute|研究所；学院
assign|指派〔任务〕；分配；分派
intelligence|智力；理解力；情报
fill|装满，盛满；占满
overhead|在头顶上的；架空的
conscience|良心，道德心
ours|我们的
borrow|借，借用，借人
landing|上岸，登陆，着陆
urgent|紧急的
roman|古罗马人 adj. 罗马的
remind|提醒，使想起
power|能力；力；权；幂
pick|镐，鹤嘴锄
possess|占用，拥有（财产）
between|在…中间
cafe|咖啡馆；小餐厅
solid|固体的 n. 固体
badly|坏，差；严重地
or|或，或者；即
individual|个别的；独特的
headquarters|总部；司令部
medal|奖章，勋章，纪念章
associate|交往 n. 伙伴，同事
post|柱，桩，杆 v. 贴出
awkward|尴尬的；笨拙的
generally|一般地；通常地
drop|使落下；降低
fine|美好的；纤细的
its|. 它的
carry|携带；运载；传送
bill|账单；票据；招贴
barber|理发师
payment|支付
tower|塔 v. 屹立，高耸
luggage|行李；皮箱，皮包
important|重要的；有势力的
flare|闪耀
off|（离）开；（停）止
dear|亲爱的 int. 啊
constant|经常的；永恒的
mode|方式；样式
coal|煤；煤块
approximate|近似的 v. 近似
defect|缺点，缺陷，欠缺
afternoon|下午，午后
worthless|无价值的，无用的
infect|传染；感染
ultimate|最后的，最终的
linen|亚麻布；亚麻织物
moist|湿润的；多雨的
anger|怒，愤怒 v. 使发怒
april|四月
fate|命运，天数
match|比赛，竞赛；对手
gasoline|（美）汽油
how|怎么；怎样；多少
patient|忍耐的 n. 病人
cunning|狡猾的，狡诈的
paragraph|（文章的）段，节
alternative|替换物；取舍，抉择
dust|尘土，灰尘
wound|创伤，伤 v. 使受伤
grade|给…分等级 n. 等级
pop|流行音乐，流行歌曲
aviation|航空，航空学
vast|巨大的；大量的
diverse|不一样的，相异的
enjoy|享受；欣赏，喜爱
potential|潜在的 n. 潜力
deceive|欺骗，蒙蔽，行骗
voltage|电压
reporter|记者，通讯员
dialog|对话，对白
air|空气；空中
circulate|使循环
garden|花园，菜园；公园
discovery|发现；被发现的事物
underline|划线于…之下
concept|概念，观念，设想
look|看，显得 n. 看
forever|永远；总是，老是
worship|礼拜；崇拜；崇拜: 爱慕：崇敬 v. 崇拜
altogether|完全；总而言之
tough|坚韧的；健壮的
glimpse|瞥见 n. 一瞥，一看
dialect|方言，土语，地方话
vertical|垂直的，竖式的
vice|罪恶；恶习
romantic|浪漫的
dictate|口授；命令
health|健康状况；健康
awful|令人不愉快的
plural|复数的 n. 复数
influential|有影响的；有权势的
piece|块；碎片 v. 拼合
free|自由的；空闲的
robot|机器人；自动机
applicable|能应用的；适当的
demonstrate|说明；论证；表露
nobody|谁也不；无人
unload|卸（货）
apologize|道歉，谢罪，认错
complex|复杂的
anxiety|焦虑，忧虑；渴望
drag|拖，拉；拖曳
clay|粘土，泥土
government|政府；治理；政治
flower|花，花卉；开花
casual|偶然的；随便的
outwards|向外，往海外
withstand|抵挡，反抗
forgive|原谅，饶恕，宽恕
eve|前夜，前夕
bind|捆绑；包扎；装订
pillar|柱，柱子；栋梁
metric|公制的，米制的
pine|松树；松木
explore|探险，探索
profession|职业
eighteen|十八，十八个
breath|气息，呼吸
gang|一帮，一伙
effort|努力；努力的成果
hardship|艰难，困苦
near|近，接近 adj. 近的
shower|阵雨；（一）阵；淋浴
alive|活着的；活跃的
indian|印度的 n. 印度人
serve|为…服务；招待
backward|向后的；倒退的
fear|害怕；担心 v. 害怕
operational|操作上的；可使用的
delay|耽搁；延误；推迟
arithmetic|算术；四则运算
value|价值；价格 v. 评价
madam|夫人，女士，太太
dangerous|危险的，不安全的
if|假如，如果
per|每
loss|遗失；损失；失败
damp|潮湿的，有湿气的
age|年龄；时代 v. 变老
launch|发射，投射；发动
stain|沾污；给…着色
vain|徒劳的；自负的
gratitude|感激，感谢，感恩
assignment|任务；指定的作业
egg|蛋，卵；蛋，鸡蛋
tailor|裁缝 v. 专门制作；订做
reliable|可靠的，可信赖的
pole|杆，柱
broad|宽的，阔的；广泛的
june|六月
accordingly|照着；因此，所以
careless|粗心的；漫不经心的
comfort|舒适；安慰 v. 安慰
facility|设备
employee|受雇者，雇员，雇工
typical|典型的，代表性的
nucleus|核，（原子）核；核心
all|全部的 pron. 全部
negative|否定的；消极的
india|印度
advanced|先进的；高级的
cottage|村舍，小屋
oblige|迫使
evaluate|评价，估…的价
skilled|有技能的，熟练的
inn|小旅店；小酒店
static|静的；静态的
forty|四十，第四十
severe|严厉的
portrait|肖像，画像
derive|取得；起源
partial|部分的；不公平的
yearly|adj&adv. 每年的
straw|稻草；麦杆；吸管
dip|浸，蘸
invite|邀请；（正式）邀请，请求
cord|细绳，粗线，索
invasion|入侵，侵略；侵犯
audience|听众，观众，读者
compound|化合物；复合词
risk|风险，危险；冒险
almost|几乎，差不多
loosen|解开；使松驰
industrialize|使工业化
glorious|光荣的；壮丽的
normally|通常；正常地
excess|超越；过量；过度
ridiculous|荒谬的，可笑的
balloon|气球，玩具气球
in|在…里；进，入
everyday|每天的，日常的
exaggerate|夸大，夸张
furthermore|而且，此外
transfer|转移；调动
criminal|犯人，罪犯，刑事犯
christian|基督教徒；信徒
cargo|船货，货物
plantation|种植园
gross|总的；严重的
gradual|逐渐的；渐进的
culture|文化，文明
position|姿势；位置；职位
four|四，四个，第四
immigrant|移民
trend|倾向
humid|湿的，湿气重的
preparation|准备，预备；制备
magnetic|磁的；有吸引力的
november|十一月
clothes|衣服，服装
glow|白热光 v. 发白热光
pad|垫；本子 v. 填塞
dusk|薄暮，黄昏，幽暗
force|强迫 n. 力，力量
rainy|下雨的，多雨的
tame|驯服的；顺从的
formal|正式的；礼仪上的
switch|开关；转换 v. 转换
fruit|水果；果实；成果
equation|方程（式）；等式
circumstance|情况，条件；境遇
eighty|八十，八十个
reach|抵达；伸出；达到
luxury|奢侈，奢华；奢侈品
pound|磅；英磅
beer|啤酒
accuracy|准确（性）；准确度
punish|罚，惩罚，处罚
poetry|诗，诗歌，诗作
idle|空闲的；懒散的
rare|稀薄的；稀有的
environment|环境，外界
island|岛，岛屿
color|颜色，彩色；颜料
extremely|极端，极其，非常
certainly|一定，必定；当然
tractor|拖拉机；牵引车
handwriting|笔迹，手迹，书法
aid|帮助；助手；救护
craft|工艺；手艺
laugh|笑，发笑 n. 笑
century|世纪；百年
hers|她的（所有物）
gravity|重力，引力；严重性
northeast|东北 adj. 位于东北的
purpose|目的；意图
issue|问题；发行 v. 发行
literary|文学（上）的
hire|租借 n. 租用，雇用
nursery|托儿所；苗圃
excite|使激动；引起
resolution|坚决，坚定；决定
disappoint|使失望，使受挫折
silver|银；银币；银器
hesitate|犹豫，踌躇；含糊
transmit|传送，传达；发射
threaten|威胁，恐吓
lap|〔坐着时的〕大腿部；一圈
tremendous|极大的，非常的
independence|独立；自主，自立
manager|经理，管理人
brass|黄铜；黄铜器
band|乐队；带；波段
proceed|进行；继续进行
expansion|扩大；扩充；扩张
from|从…来
elimination|排除，消除；消灭
defend|保卫，防守
significant|有意义的；重要的
always|总是，一直；永远
rod|杆，竿，棒
mainland|大陆
maximum|最大量 adj. 最大的
honeymoon|蜜月
content|满意的，满足的
scholar|学者（尤指文学方面）
tedious|冗长乏味的，沉闷的
late|迟的 adv. 迟，晚
germany|德意志，德国
figure|数字；外形；人物
clearly|明白地，清晰地
follow|跟随；结果是
fortunately|幸运地，幸亏
particle|微粒；粒子
version|说法；译文；改写本
pink|粉红色 adj. 粉红色的
bring|带来；引出；促使
ground|地；场地；根据
pursue|进行；追赶，追踪
film|影片；胶卷；薄层
canada|加拿大
propose|提议；求婚
recorder|录音机；记录者
economy|经济；节约，节省
sensible|明智的；感觉得到的
among|在…之中
discussion|讨论，谈论；论述
republic|共和国，共和政体
yawn|打呵欠 n. 呵欠
lawn|草地，草坪，草场
gas|气体；煤气；汽油
distant|在远处的；疏远的
ability|能力；能耐；本领
instinct|本能；直觉；生性
approval|批准；赞成，同意
await|等候，期待
lemon|柠檬，柠檬树
triangle|三角（形）
advise|劝告；建议；通知
bank|银行；库；沿，堤
measurement|尺寸；衡量，测量
help|帮助；援助 n. 帮手
justice|司法；正义，公正
remember|记得；想起；记住
widow|寡妇
telescope|望远镜
even|甚至；甚至更，还
booth|公用电话亭；货摊
final|最后的；决定性的
receiver|收受者，收件人
drought|旱灾，干旱
tin|锡；罐头
left|左边的
resign|放弃
farm|农场，农庄；饲养场
miner|矿工
prosperity|繁荣；昌盛，兴旺
britain|不列颠，英国
mix|使混合，混淆
average|平均数 adj. 平均的
pinch|捏，拧，掐掉
whip|鞭笞；搅打 n. 鞭子
fond|喜爱的；溺爱的
expression|词句；表达；表情
five|五，五个，第五
agriculture|农业，农艺；农学
anyhow|无论如何
transistor|晶体管
house|房屋，住宅；商号
knob|门把，拉手；旋纽
religion|宗教信仰；宗教
factor|因素；系数；因子
inexpensive|花费不多的，廉价的
finish|完成；结束 n. 结尾
phenomenon|现象
allow|允许，准许；任
keen|热心的；激烈的
presently|一会儿；目前
statistical|统计的，统计学的
vitamin|维生素，维他命
enemy|敌人；仇敌；敌兵
eight|八，八个
design|设计 n. 设计；图样
cream|奶油，乳脂；奶油色
duty|责任；职责；税
cousin|堂（或表）兄弟（姐妹）
lamb|羔羊，小羊；羔羊肉
canteen|小卖部；临时餐室
clear|清晰的 v. 清除
whilst|当…的时候
bake|烤，烘，焙；烧硬
airplane|飞机
coat|外套，上衣；皮毛
intention|意图，意向，目的
interruption|障碍物；中断，打断
wreck|沉船，失事船 v. 破坏
affair|事务；事情，事件
mill|磨坊；制造厂
cup|杯子；（一）杯；奖杯
chill|使变冷 n. 寒冷
physicist|物理学家
oppose|反对；反抗
hurry|赶紧；催促
bad|坏的，恶的；严重的
prohibit|禁止；阻止
pig|猪，小猪，野猪
grandfather|祖父；外祖父
gain|获得；增加 n. 增进
sideways|斜着，斜向一边地
except|除…之外
weave|织，编
consist|由…组成；在于
heir|后嗣，继承人
continual|不断的；连续的
image|图像；映像；形象；印象
insult|侮辱，凌辱 n. 侮辱，凌辱
unexpected|想不到的，意外的
art|艺术，美术；技术
reward|报答；报酬 v. 报答
simplicity|简单，简易；朴素
interview|接见；会见；面谈
buy|买，购买
opposite|对面的 n. 对立物
girl|女孩子，姑娘；女儿
chess|棋；国际象棋
quote|引用，引证；报价
exhibit|陈列，展览；显示
resistant|抵抗的；反抗的
kite|风筝
stroke|中风；打，击；鸣声
move|移动；感动 n. 动
beneficial|有利的，有益的
sow|播（种）
prepare|准备，预备
millimetre|毫米
council|理事会，委员会
grocery|食品杂货店
interfere|干涉，干预；妨碍
glue|胶，胶水 v. 胶合
imaginary|想象中的，假想的
contemporary|当代的；同时代的
at|在…里；在…时
crow|鸦，乌鸦 v. 啼
depend|依靠，依赖；相信
item|一项，一件，一条
entire|全部的，整个的
charge|索价；控告 n. 费用
behavior|行为，举止，态度
provided|以…为条件
thus|如此，这样；因而
agreement|协定，协议；同意
device|器械，装置
clothing|衣服
cube|立方形；立方
marriage|结婚，婚姻；婚礼
kingdom|王国；界
bow|鞠躬；弓；蝴蝶结
vessel|船，飞船；管；容器
automatic|自动的；机械的
trace|痕迹；丝毫 v. 跟踪
overnight|一夜；突然
feather|羽毛；翎毛；羽状物
monday|星期一
export|出口；输出
badminton|羽毛球
arrival|到达；到来；到达者
knock|敲，击，打 n. 敲，击，打
fifteen|十五；十五个
aunt|伯母，婶母，姑母
motive|动机，目的
capture|捕获，俘获；夺得
handful|一把；少数，一小撮
being|存在；生物；生命
contract|契约，合同
collective|集体的；集合性的
building|建筑物，大楼；建筑
crew|全体船员
postman|邮递员
corresponding|相应的；符合的
restless|不安定的，焦虑的
tempt|引诱，诱惑；吸引
fix|决定；使固定
classroom|教室，课堂
corridor|走廊，回廊，通路
daughter|女儿
out|出，在外；现出来
outdoors|在户外，在野外
universal|全世界的；全体的；共同的；普遍的
garage|车库；加油站
mark|斑点；记号 v. 标明
outcome|结果，后果，成果
duration|持续，持久
consideration|考虑，思考；体贴
mould|模子，模型 v. 浇铸
already|早已，已经
tune|调子 v. 调音
logical|逻辑的；符合逻辑的
book|书，书籍 v. 预定
heavy|重的；大的；充满的
loan|贷款；暂借 v. 借出
peach|桃子，桃树
danger|危险；危险事物
horsepower|马力
prevent|预防，防止；阻止
yield|出产 n. 产量
punch|用拳猛击 n. 冲压机
calculator|计算器，计算者
plate|盘 v. 电镀
disclose|揭开，揭发；透露
communication|通讯；传达；交通
slide|滑 n. 滑
candidate|候选人；投考者
mount|登上，爬上 n. …山
rat|老鼠，耗子
neighbour|邻居，邻人；邻国
ceremony|典礼，仪式；礼节
fiction|小说；虚构，杜撰
determine|查明；决定；决心
plan|计划，打算 v. 计划；打算
greek|希腊的 n. 希腊人
party|聚会；党，党派
further|更远地 adj. 更远的
radio|无线电；收音机
contribute|捐献，捐助；投稿
catalog|目录，目录册
coward|懦夫；胆怯者
apply|应用，实施，使用
throat|咽喉，喉咙；嗓音
ice|冰，冰块 v. 冰敷
piano|钢琴
discuss|讨论，谈论；论述
neat|整洁的
refresh|使清新；恢复精神
curiosity|好奇，好奇心；珍品
divide|分；分开；分配
leader|领袖，领导人；首领
fibre|纤维质；纤维
trim|整齐的 v. 使整齐
baby|婴儿；孩子气的人
wooden|木制的；呆板的
clap|拍手；拍，轻拍
vibrate|使颤动
honest|诚实的
necklace|项链，项圈
blame|责备，把…归咎于
substance|物质；实质；本旨
merry|欢乐的，愉快的
fountain|泉水，喷泉；源泉
surroundings|周围的事物，环境
chair|椅子；主席
procession|队伍，行列
back|回原处；回；在后
jacket|短上衣，茄克衫
rifle|步枪，来复枪
our|我们的
low|低的；矮的；低下的
opponent|对手，敌手；对抗者
pretend|假装
bathroom|浴室；盥洗室
champion|冠军，得胜者
jump|跳；暴涨
count|计算；数，计数
vivid|生动的；鲜艳的
biscuit|（英）饼干；（美）软饼
orange|橙（树）；柑（树）
advantage|优势；优点；好处
upper|上面的；地位较高的
senior|地位较高的
regular|规则的；整齐的
majority|多数，大多数
blossom|花；开花 v. 开花
heading|标题，题词，题名
fridge|电冰箱
destruction|破坏，毁灭，消灭
commerce|商业，贸易；社交
transmission|传送；传动；发射
german|德国的 n. 德国人
elsewhere|在别处，向别处
british|不列颠的，英联邦的
discover|发现
series|连续，系列；丛书
personnel|全体人员，全体职员
faulty|有缺点的；有错误的
inherit|继承（传统等）
famous|著名的，出名的
only|只，仅仅 adj. 唯一的
resolve|解决；决心 n. 决心
gold|金 adj. 金制的
leisure|空闲时间；悠闲
breathe|呼吸
metre|米，公尺
rainbow|虹，彩虹
furniture|家具
outer|外部的，外面的
college|学院；大学
mother|母亲，妈妈
hour|小时；时间；时刻
respective|各自的，各个的
crop|农作物，庄稼；一熟：一季的收成
feel|有知觉；触，摸
ounce|盎司，英两
handle|柄，把手 v. 拿，触
active|活跃的；积极的
conservation|保存，保护
game|游戏；比赛；猎物
devil|魔鬼，恶魔
imagination|想象；想象力；空想
opinion|意见，看法，主张
maid|女佣，女仆；少女
admire|钦佩，羡慕，赞赏
yard|院子，庭院；场地
doctor|医生，医师；博士
dam|水坝，水堤；障碍物
ripe|熟的；时机成熟的
soil|弄脏
earth|地球；陆地，地面
alphabet|字母表，字母系统
lucky|幸运的；吉祥的
waggon|四轮运货马车
restore|恢复；修补；归还
complicated|难懂的；复杂的
regret|懊悔；抱歉 n. 懊悔
rack|搁物架；行李架
lace|鞋带，系带；花边
jolly|快活的；令人高兴的
area|地区；面积；领域
oceania|大洋洲
chemical|化学的 n. 化学制品
ocean|海洋；洋
lord|贵族；上帝
intelligent|聪明的；理智的
loop|圈，环，环孔
greedy|贪吃的；贪婪的
everything|每件事，事事
feedback|反馈
total|总的 v. 合计，总共
ad|广告
check|检查；制止 n. 检查
create|创造；引起，产生
cheap|廉价的；劣质的
reject|拒绝；驳回；丢掉
anyway|无论如何
decorate|装饰，装璜，修饰
string|线，细绳；一串
moisture|潮湿，湿气
memory|记忆；回忆；存储
accept|接受；同意
behind|在…后面
investment|投资，投资额；投入
false|不真实的；伪造的
increase|增加 n. 增加
guest|客人，宾客；旅客
constitution|章程；体质；构造
illegal|不合法的，非法的
carriage|四轮马车；客车厢
summarize|概括，概述，总结
raw|未煮过的；未加工的
extension|延长部分；伸展
polite|有礼貌的；有教养的
broom|扫帚
thereby|因此，从而，由此
threat|威胁，恐吓；凶兆
justify|证明…是正当的
strategy|战略；策略
box|箱，盒；包厢
simplify|简化，使单纯
usage|使用，对待；惯用法
aloud|出声地；大声地
delight|快乐 v. 使高兴
cripple|跛子；残疾人
cigaret|香烟，纸烟，卷烟
square|正方形；广场
pray|祈祷；请求
attraction|吸引；吸引力；引力
reputation|名誉，名声；好名声
decrease|减少 n. 减少
cave|山洞，洞穴，窑洞
banana|香蕉；芭蕉属植物
unknown|不知道的；未知的
despite|尽管，虽然，任凭
transportation|运输，运送，客运
collar|衣领；项圈
lean|倾斜，屈身；靠
undergraduate|大学在校生
material|材料；素材 adj. 物质的
neutral|中立的；中性的
male|男的，雄的 n. 男子
circle|圆；圆周；圈子
thickness|厚（度）；密（度）
news|新闻；消息
wicked|坏的；令人厌恶的
suspicious|怀疑的；可疑的
shoot|发射；射中 n. 芽
publication|出版；出版物；公布
possibility|可能；可能的事
lie|躺；平放；位于
quarrel|争吵，吵架，口角
here|这里；向这里
scrape|刮；擦 n. 刮；擦伤；擦痕
example|例子，实例；模范
bible|基督教《圣经》
stability|稳定；稳定性
equip|装备，配备
forest|森林；森林地带
reasonable|合情合理的；公道的
quit|离开，退出；退出；停止
lower|较低的 v. 放下
beneath|在…下方
transform|改变；改造；变换
musician|音乐家；作曲家
attribute|把…归因于 n. 属性
saddle|鞍子，马鞍
trunk|树干；大衣箱，皮箱
submit|服从
customer|顾客，主顾
observation|注意；观察；观察力
moderate|温和的；有节制的
cope|对付，应付
king|国王，君主
reaction|反应；反作用力
outlook|观点，看法；展望
member|成员，会员
passport|护照
reduction|减少，减小，缩减
childhood|童年，幼年；早期
corner|角；边远地区
grandmother|祖母，外祖母
lightning|闪电，闪电放电
of|…的；由于
classification|分类；分级；分类法
tension|紧张，不安；拉紧；张力
strip|剥去；除去 n. 条，带
interpretation|解释
condemn|谴责，指责；判刑
previous|先的；前的
hopeful|有希望的
invisible|看不见的；无形的
occasion|场合；时刻；时机
noun|名词
blend|混和 n. 混和物
colleague|同事，同僚
electronic|电子的
fire|火；火灾 v. 开火
layer|层；层次
fade|逐渐消失；褪色
ahead|向前；在前；提前
chop|砍，劈；切细
gulf|海湾
convenient|便利的；近便的
eleven|十一，十一个
by|在…旁；被，由
australian|澳大利亚的
main|主要的，最重要的
candy|糖果
bacteria|细菌
repeatedly|重复地；一再
explanation|解释，说明；辩解
impact|影响，作用；冲击
mainly|主要地，大体上
administration|管理；管理部门
skillful|灵巧的，娴熟的
data|数据；资料
pollution|污染
possession|有，所有；占有物
manly|男子气概的，果断的
reverse|颠倒；翻转 n. 背面
gallon|加仑
have|aux v. （与过去分词连用构成完成时） v. 有；吃
boy|男孩，少年；家伙
mister|先生
crawl|爬，爬行
employment|工作；职业；雇用；使用
dread|畏惧；恐怖 v. 惧怕
difficult|困难的；难对付的
aggressive|侵略的；好斗的
elder|年龄较大的 n. 长者
twin|孪生的 n. 孪生儿
furnace|炉子，熔炉；鼓风炉
political|政治的，政治上的
statue|塑像，雕像，铸像
geometry|几何，几何学
union|协会；联合
accord|给予；使一致
terminal|末端的 n. 〔飞机、公共汽车、轮船客运或货物运输的〕集散站，终点站
petroleum|石油
northwest|西北 adj. 位于西北的
wool|羊毛；毛线，绒线
hollow|空的；空洞的
mission|使命，任务；使团
lantern|提灯，灯笼
earnest|认真的，诚恳的
lavatory|盥洗室，厕所
oneself|自己；亲自
familiar|熟悉的
rocket|火箭，火箭发动机
veteran|老兵；老手
declare|断言；声明；表明
span|持续时间；跨距
bunch|束，串；一群
approve|批准；赞成，称许
hobby|业余爱好，癖好
pea|豌豆；豌豆属植物
collapse|倒坍；崩溃，瓦解
insect|昆虫，虫
he|（主格）他
eat|吃
add|添加，附加，掺加
growth|增长；增长量；生长
strange|陌生的；奇怪的
invention|发明，创造；捏造， 假话
female|雌性的动物；女性
disaster|灾难，灾祸；天灾
headache|头痛；头痛的事
comment|评论，意见；批评；指责
damage|损害，毁坏 n. 损害
assure|使确信；向…保证
store|商店；贮藏；贮存品
withdraw|撤退；收回；撤回
conduct|举止，行为
bulb|电灯泡
alcohol|酒精，乙醇
bitter|痛苦的；严寒的
respond|作答；响应
naked|裸体的；无遮敝的
radar|雷达，无线电探测器
birthday|生日；诞生的日期
precise|精确的，准确的
emerge|出现，涌现；冒出
reality|现实；真实
wing|翼，翅膀，翅
gauge|量，测量 n. 量器
give|做，作；送给
end|末端；目标 v. 结束
rust|锈 v. 生锈，氧化
disagree|有分歧；不一致
engineer|工程师，技师
expert|专家 adj. 熟练的
plain|平原 adj. 清楚的
philosopher|哲学家
eastern|朝东的；东方的
automobile|汽车，机动车
noon|正午，中午
region|地区，地带；领域
transformation|变化；改造；转变
benefit|利益；恩惠；津贴
least|det,pron. 最少的 adv. 最少
grind|磨（碎）；磨利
do|（用于实义动词前构成否定句和疑问句） v. 做，干，办
national|民族的；国家的
excursion|远足；短途旅行
haste|急速，急忙；草率
suit|起诉，诉讼 v. 适合
stock|库存品；股本
needless|不需要的
laser|激光
boot|靴子，长统靴
pain|痛，疼痛；辛苦
stale|陈腐的；走了气的
habitual|习惯性的，惯常的
erect|建造；使竖立
noticeable|显而易见的
hate|恨，憎恨；不喜欢
orderly|整洁的；有秩序的
menu|菜单
fair|公平的；相当的
point|点；要点；细目；分
live|居住；活 adj. 活的
altitude|高，高度；高处
horizon|地平线；眼界，见识
similarly|类似地，相似地
protein|蛋白质，朊
miserable|痛苦的；悲惨的
influence|影响；势力 v. 影响
july|七月
sake|缘故，理由
tendency|倾向；趋向，趋势
giant|〔儿童故事中的〕巨人；巨人；巨物
father|父亲；神父；创始人
specimen|样本，标本，样品
upward|上升的；向上的
ready|准备好的；愿意的
path|路，小道；道路
helmet|头盔，钢盔
adverb|副词
information|消息，信息；通知
exterior|外部的
setting|环境；安装，调整
tidy|整洁的；整齐的
eagle|鹰
variable|易变的 n. 变量
belt|带，腰带；皮带；区
open|开的；开放的 v. 开
relative|有关系的；相对的
cage|笼；鸟笼，囚笼
revolt|反抗；造反 v. 反抗；造反
exist|存在；生存，生活
width|宽度
argue|争论；争辩，辩论
herself|她自己；她亲自
potato|马铃薯，土豆
aspect|方面；样子，外表
fertile|肥沃的
chamber|〔人体内或某些机器中的〕室，腔；会议室；房间
rotary|旋转的，转动的
elbow|肘，肘部；弯管
dye|染 n. 染料；染色
condition|状况，状态；环境
deaf|聋的；不愿听的
prize|奖赏，奖金 v. 珍视
knit|把…编结
neither|（两者）都不的
register|登记，注册 v. 登记，注册
flu|流行性感冒
petrol|（英）汽油
continent|大陆；陆地；洲
echo|回声，反响 v. 重复
boil|沸腾；汽化；煮沸
accident|意外事件；事故
log|原木，木料
cheat|骗取；哄
grass|草；牧草；草地
desire|中文释义；想要：要求 n. 愿望
dense|密集的；浓厚的
tank|大容器，槽；坦克
restrict|限制，限定；约束
first|第一 adv. 最初
deliver|投递，送交；发表
reduce|减少，减小
aircraft|飞机，飞行器
specific|特有的；具体的
scout|侦察员，侦察机
instant|瞬间 adj. 立即的
involve|使卷入；牵涉
layout|布局，安排，设计
business|商业，生意；事务；事务
torture|拷问；折磨 v. 拷打
shiver|颤抖，哆嗦 n. 冷颤
contradiction|矛盾，不一致；否认
photograph|照片，相片
sophisticated|老于世故的；高级的
exploit|剥削；利用；开拓
likewise|同样地；也，又
ratio|比，比率
textile|纺织品
employer|雇佣者，雇主
fisherman|渔民，渔夫，打鱼人
love|爱，喜欢 n. 爱
arrive|到达；来临；达到
preferable|更可取的，更好的
indifferent|冷漠的；不积极的
impatient|不耐烦的，急躁的
vapour|汽，蒸气
chemist|化学家；药剂师
novel|小说 adj. 新的
forward|向前；今后，往后
civilize|使文明；教育
nail|钉；指甲 v. 钉
harsh|严厉的；刺耳的
fail|失败；不能；失灵
disturb|打扰，扰乱；弄乱
favourable|赞成的；有利的
exciting|令人兴奋的
seize|抓住；夺取；逮捕
day|（一）天；白昼，白天
onto|到…上
ninety|九十，九十个
application|请求，申请；施用
plot|小块土地 v. 密谋
hotel|旅馆
encourage|鼓励，支持；助长
concentrate|集中；聚集；浓缩
achievement|成就，成绩；完成
comparison|比较，对照；比拟
build|建筑；建立；创立
bosom|胸，胸部；内心
bother|烦扰，迷惑 n. 麻烦
festival|〔电影、戏剧、音乐等的〕节，节庆，会演；节日
ensure|保证；保护；赋予
face|脸；表面
handy|便于使用的；手边的
honesty|诚实，正直
genuine|真的；真正的
cycle|循环；自行车
parent|父亲，母亲，双亲
graph|（曲线）图，图表
seal|印记；封蜡 v. 封
strengthen|加强，巩固
deny|否定；拒绝相信
empire|帝国
surgery|外科，外科手术
fortune|运气；巨款；命运
interesting|有趣的，引人入胜的
project|方案，工程 v. 伸出
again|又一次；而且
favour|恩惠；赞同
fleet|舰队；机群
mankind|人类
liter|升（容量单位）
mechanics|力学
schedule|计划表；时间表
crystal|结晶体；晶粒；水晶
letter|信；字母
effective|有效的；有影响的
eye|眼睛；眼力
card|卡；卡片；名片
bush|灌木，灌木丛，矮树
rouse|唤醒，唤起；惊起
reflexion|映象；反映；反射
arabian|阿拉伯的
widen|变宽；加宽
violent|暴力的；强暴的；猛烈的；狂暴的
basic|基本的，基础的
director|理事；导演；指导者；负责人
own|自己的 v. 有，拥有
commit|犯（错误）；干（坏事）
ampere|安培
blast|爆炸，冲击波 v. 炸
doubtless|无疑地；很可能
cloak|斗篷；覆盖（物）
comprehensive|广泛的
mistress|女主；夫人
mathematics|数学
housewife|家庭主妇
headmaster|校长
oak|栎属植物；栎木，橡木
available|可利用的
no|不；并不 adj. 没有
somebody|某人，有人
rotation|旋转，转动
virtue|善；美德；优点
urban|都市的，住在都市的
hardware|硬件；五金器具
annoy|使恼怒；打搅；打扰
centigrade|百分度的
ink|墨水，油墨
parallel|平行的；相同的
naughty|顽皮的，淘气的
cassette|盒式录音带
fifth|第五 n. 五分之一
organization|组织；团体，机构
hall|门厅；过道；会堂
prevail|流行；胜，优胜
continue|继续，连续；延伸
microcomputer|微型计算机，微机
persist|坚持，固执；持续
unless|除非，如果不
manage|管理；设法；成功应付，对付
owner|物主，所有人
weep|哭泣，流泪
vacuum|真空；真空吸尘器
realize|认识到；实现
predict|预言，预告，预测
portable|轻便的；手提的
ditch|沟，沟渠，渠道
relief|减轻；救济；援救
accommodate|容纳；供应，供给，提供住宿
laboratory|实验室，研究室
brush|刷子，毛刷；画笔
microscope|显微镜
emperor|皇帝
render|使得；表示，给予
plug|塞子；插头 v. 塞
consult|请教；查阅
candle|蜡烛
range|一系列；范围；山脉
adult|成年人 adj. 成年的
approach|向…靠近 n. 靠近
eventually|终于；最后
glad|高兴的；乐意的
conclude|推断出；结束
radiation|辐射；辐射能
accidental|偶然的；非本质的
dog|狗，犬；犬科动物
automation|自动，自动化
huge|巨大的，庞大的
few|很少的；少数的
angel|天使；安琪儿，天使〔指仁慈、善良或美丽的人〕
handsome|英俊的；相当大的
class|班，班级；阶级；等级
nation|国家；民族
complaint|抱怨；怨言；控告
era|时代，年代；纪元
port|港，港口
column|柱，支柱，圆柱
message|信息，消息；启示，要旨，寓意
pack|（把…）打包；（把…）装箱；挤满 n. 包
black|黑色的；黑暗的
scan|细看；浏览；扫描
variation|变化，变动；变异
planet|行星
lend|把…借给；贷（款）
reflection|映象；反射；反映
acre|英亩
removal|移动；移走；除掉；搬迁
sail|帆；船 v. 航行
france|法国，法兰西
superior|有优越感的；较高的
cafeteria|自助食堂
costly|昂贵的；代价高的
ideal|理想的
sample|样品；标本
continuous|连续不断的，持续的
joy|欢乐，喜悦；乐事
navy|海军
fabric|织物，纺织品；结构
evolve|使进化；使发展
eliminate|消灭，消除；排除
staff|全体职员，员工；工作人员；参谋
repeat|重说，重做 n. 重演，重现
narrow|狭的，狭窄的
freight|货运；货物；运费
educate|教育；培养；训练；教导
fence|栅栏
lick|舔；舔吃
necessary|必要的；必然的
primitive|原始的；老式的，简陋的
read|读，看懂
and|和，又，并；则，那么
complain|抱怨，诉苦；控告
thrust|插，刺 n. 猛冲，猛刺；推进
junior|青少年的 n. 晚辈
leading|最主要的
spur|刺激物 v. 刺激
commercial|商业的；商品化的
extraordinary|非同寻常的；特别的（会议）
inspire|鼓舞；给…以灵感
climate|气候；地带；风气
outward|外面的；向外的
pessimistic|悲观的；厌世的
frost|冰冻，严寒；霜
curse|诅咒，咒骂
heroic|英雄的；英勇的
dive|跳水；潜水；俯冲
survey|调查；测量
leak|漏；泄露 n. 漏洞
democratic|民主的，民主政体的
apart|相隔；分开；除去
resort|求助，凭借；诉诸于 n. 诉诸
utter|完全的，彻底的
penetrate|穿过
passenger|乘客，旅客
compete|竞争；对抗；比赛
boast|自夸，吹嘘
breadth|宽度，幅度；幅面
unique|唯一的，独一无二的
opportunity|机会，良机
precious|珍贵的，宝贵的
accurate|准确的，正确无误的
feeble|虚弱的；微弱的
kind|种类
helpful|给予帮助的；有用的
apology|道歉，认错，谢罪
lighten|照亮，使明亮
hot|热的；刺激的；辣的
hasty|急速的；仓促的
civil|公民的；普通公民的；平民的
able|有能力的；出色的
drive|驾驶；打入；驱
eleventh|第十一（个）
friction|摩擦；摩擦力
expectation|期待，预期；期望
commission|委员会；委任状
old|老的；…岁的
night|夜，夜间
joyful|十分喜悦的，快乐的
highly|很，非常；高度地
full|满的；完全的
detail|细节；枝节
foot|脚；最下部；英尺
tag|标签；附加语
cash|现金，现款
vanish|突然不见，消失
movie|电影；电影院
convert|使转变；使改变
although|尽管，虽然
submerge|浸没；潜入水中
event|事件，大事；事变
jam|果酱
display|陈列，展览；显示
mutton|羊肉
exhaust|使筋疲力尽；用尽
pot|锅；壶，罐，盆
murder|谋杀，凶杀 v. 谋杀，凶杀
language|语言；语言课程
wire|金属线；电缆
honourable|光荣的
nationality|国籍；民族，族
remove|移动，搬开；脱掉
spacecraft|航天器，宇宙飞船
channel|海峡；渠道；频道
lunch|午餐，（美）便餐
form|形式；形状 v. 形成
soak|浸，泡
mobile|运动的；流动的
dim|昏暗的；朦胧的
death|死，死亡；灭亡
inevitable|不可避免的，必然的
host|主人；东道主
marxist|马克思主义的
pork|猪肉
expect|预料，预期；等待
disorder|骚乱；混乱，杂乱
triumph|凯旋；胜利 v. 成功
jaw|颌，颚
peak|山顶，巅 adj. 最高的
practically|实际上；几乎
exclusively|专门地
noble|贵族的；高尚的
liberty|自由；释放；许可
graceful|优美的，优雅的
joint|关节；接头，接缝
sweep|扫；刮起；扫过
session|一段时间；会议
countryside|乡下，农村
miss|小姐
hundred|百，百个 n. 许多
tube|管；电子管，显像管
jungle|丛林，密林，莽丛
fool|蠢人，傻子 v. 欺骗
optical|眼的；光学的
attentive|注意的；有礼貌的
anybody|任何人
complete|完整的；完成的
depth|深度；深厚；深处
participate|参与，参加；分享
tire|疲劳，累；厌倦
god|神，神像；上帝
habit|习惯；习性
enlarge|扩大，扩展；放大
bargain|交易 v. 议价
revolutionary|革命的 n. 革命者
instance|例子，实例，事例
considerate|考虑周到的；体谅的
dismiss|不再考虑；解雇
dare|敢；竟敢
odour|气味，味道
cultivate|耕；种植；培养
thunder|雷 v. 打雷；吼出
enclose|附上；围住，圈起
enter|走进，进入；参加
introduce|介绍；引进；传入
judgement|判断；意见；审判
pool|游泳池；水塘，水池
daring|大胆的，勇敢的
postpone|延迟，推迟，延缓
telegram|电报
fund|基金；资金
lifetime|一生，终身
control|控制；克制 n. 控制
bronze|青铜；青铜制品
pit|坑，地坑；煤矿
lab|实验室，研究室
dynamic|有活力的；动力的
disable|使无能，使伤残
comparative|比较的；相对的
gate|大门；篱笆门
seed|种（子），籽；起因，萌芽
worthwhile|值得花时间的
fame|名声，名望
doubtful|难以预测的；怀疑的
distinguish|区别，辨别；认别
concert|音乐会，演奏会
famine|饥荒
slice|薄片，切片；部分
invade|入侵，侵略；侵袭
celebrate|庆祝；歌颂，赞美
prisoner|囚犯
temporary|暂时的，临时的
princess|公主；王妃
treasure|财富；珍宝 v. 珍视
ill|有病的；坏的 adv. 恶劣地；讨厌地
comrade|亲密的同伴；同志
fragment|碎片，破片，碎块
problem|问题；习题，问题
enough|足够的 adv. 足够地
address|地址；演说
bath|浴，洗澡；浴缸
invent|发明，创造；捏造
provision|供应；预备；存粮
coordinate|使协调，调节
devote|将…奉献，致力于
inside|在…里面 n. 内部
valid|有效的；正当的
oh|嗬，哦，唉呀
liberate|解放；释放
talk|讲话；谈论
ever|在任何时候；曾经
bark|吠叫声 v. 吠，叫
horror|恐怖；战栗；憎恶
deduce|演绎，推论，推断
deserve|应受；值得
overcome|克服；战胜
angry|愤怒的，生气的
asian|亚洲的 n. 亚洲人
dress|服装
inefficient|效率低的，无能的
mouthful|满口，一口
appetite|食欲，胃口；欲望
hospital|医院
fortnight|两星期，十四天
chew|咀嚼，嚼碎
optional|可以任意选择的
assist|援助，帮助
carpet|地毯，毡毯，毛毯
probability|可能性；概率
railway|铁路，铁道
each|det,pron. 各，各自
explosion|爆炸，炸裂；爆发
racial|种族的；人种的
clerk|办事员，职员；店员
asleep|睡着的，睡熟的
possible|可能的；可能存在的
hostess|女主人
exception|例外，除外
cathedral|总教堂；大教堂
acceptance|接受，验收；承认
might|可能，会，也许
unite|联合
ox|阉牛；牛；公牛
recovery|重获；痊愈；恢复
fellow|家伙；伙伴
brown|褐色，棕色
blind|瞎的；盲目的
dash|使猛撞；溅 n. 猛冲
must|必须；必然要
importance|重要；重要性
reception|接待；招待会
cap|帽子，便帽；帽状物
captain|陆军上尉；队长
rigid|刚硬的；僵硬的
mistake|错误 v. 误解，弄错
depart|离开，起程；出发
engage|使从事于；聘用
crazy|疯狂的，荒唐的
butcher|屠夫；屠杀者
pay|支付；付给；给予
lonely|孤独的；荒凉的
corn|谷物；（英）小麦
pierce|剌穿
revise|修订，校订；修改
primarily|首先；主要地
field|田野；田；运动场
compromise|妥协，和解
crane|起重机，摄影升降机
future|将来，未来；前途
external|外部的，外面的
fraction|小部分；片断；分数
delicate|纤细的；易碎的
abundant|丰富的；大量的
brittle|脆的；易损坏的
claim|声称，主张；索取
appreciate|领会；感谢；欣赏
about|关于；在…周围
parade|游行；检阅 v. 游行
furnish|装备，布置 （房间、建筑物）；供应，提供
mourn|哀痛，哀悼
hazard|危险；公害
choice|选择，抉择
liable|易于…的；可能的
sum|金额；总数
foreigner|外国人
mud|软泥，泥浆
reveal|揭示，揭露；展现
fold|折叠；合拢 n. 褶
beard|胡须，络腮胡子
illustrate|（用图等）说明
protect|保护，保卫，警戒
airline|航空公司
military|军事的；军人的
negro|黑人
deep|深的；纵深的
storey|（层）楼
willing|愿意的，心甘情愿的
quarter|四分之一；一刻钟
obey|顺从
pattern|型，式样；模，模型
lightly|轻轻地，轻松地
suppose|猜想；假定
case|情况；病例；事实
overcoat|外衣，大衣
installation|安装；装置；设施
niece|侄女，外甥女
incline|斜坡 v. 使倾斜
superficial|肤浅的；表面的
appointment|约定，约会；任命
tyre|轮胎，车胎
failure|失败；失败的人
beauty|美，美丽；美人
painting|油画；绘画；着色
frown|皱眉，蹙额
drown|淹死，溺死
resemble|像，类似
pressure|压力；〔工作或生活中的〕压力；压，按
remarkable|异常的，非凡的
muscle|肌肉，肌；体力
nap|小睡，打盹，瞌睡
polish|磨光；使优美
company|公司，商号；同伴
critical|批评的；决定性的
renew|使更新
maintain|维持；赡养；维修
computer|计算机，电脑
feasible|可行的；可能的
transformer|变压器
vehicle|车辆，机动车
politician|政治家；政客
regard|把…看作
oral|口头的；口的
height|高，高度；高处
approximately|近似地，大约
long|渴望，极想念
bit|一点，一些，小片
sole|脚底；鞋底，袜底
imprison|关押，监禁；限制
folk|人们；家属，亲属
carve|刻，雕刻；切开
practice|练习；实践；业务
element|成分；要素；元素
rapid|快的
rational|理性的；出于理性的
indispensable|必不可少的，必需的
contact|与…联系
treatment|待遇；治疗，疗法
insure|给…保险；确保
excellent|优秀的，杰出的
loyal|忠诚的，忠心的
dull|枯燥的；不鲜明的
ghost|鬼，灵魂；鬼魂
mortal|终有一死的；致死的
identify|认出，识别，鉴定
iron|铁 v. 烫（衣）
china|中国
collision|碰撞；冲突
harmful|有害的
volume|音量；容积；卷，册
bull|公牛；雄的象
mask|面具；伪装 v. 掩饰
crime|犯罪；罪，罪行
debate|争论，辩论 v. 争论，辩论
newspaper|报纸，报
criticize|批评；非难；评论
pencil|铅笔
courage|勇气，胆量，胆识
forehead|额头，前部
perceive|理解；察觉，发觉
place|地方，地点；住所
joke|笑话 v. 说笑话
sheet|被单；纸张；薄板
dot|点，圆点 v. 打点于
balance|使平衡 n. 天平
melon|瓜，甜瓜
injure|伤害，损害，损伤
cucumber|黄瓜
flame|火焰；热情
less|更少的 adv. 更少地
peace|和平；平静；和睦
solve|解决；解答，解释
basis|基础，根据
once|一次；曾经
bus|公共汽车
husband|丈夫
haircut|理发
kiss|吻 n. 吻
pet|爱畜；宠儿
harvest|收获；收成 v. 收割
considerable|相当大的；重要的
cordial|真诚的，诚恳的
sketch|略图；速写；概略
avenue|大街；林荫道，道路
bright|明亮的；聪明的
intimate|亲密的；个人的
locate|探明，找出，查出
pride|骄傲；自豪 v. 自夸
ore|矿，矿石，矿砂
cupboard|碗柜，碗碟橱；食橱
battery|电池；一套，一组
impression|印象；印记
waterproof|不透水的，防水的
find|找到；找出；发觉
chapter|章，回，篇
powerful|有权威的；强有力的
overtime|加班；加班的时间
carrier|运输工具；运载工具
troop|军队；一群，大量
garbage|垃圾，污物，废料
literature|文学；文献
excessive|过多的，极度的
nasty|龌龊的；淫猥的
aboard|在船（车）上；上船
outdoor|户外的，室外的
accuse|指责；归咎于
heaven|天堂；天，天空
include|包括，包含
poisonous|有毒的，有害的
medicine|内服药；医学
europe|欧洲
examine|检查，仔细观察
halt|停止；立定 n. 停住
endure|忍受；容忍
opening|开始的 n. 开始
silence|沉默 v. 使沉默
missile|导弹；发射物
executive|执行的 n. 执行者
reliability|可靠性
granddaughter|孙女，外孙女
occasional|偶然的；临时的
fortunate|幸运的；侥幸的
ear|耳朵；听力，听觉
sequence|次序
guarantee|保证；担保物
link|有环连接 n. 环
actual|实际的
after|在…以后；次于
access|通道，入口
recently|最近，新近
intellectual|知识分子 adj. 智力的
rotate|旋转
deck|甲板；舱面；层面
plough|犁 v. 犁，耕
poison|毒，毒药 v. 毒害
perhaps|也许，可能，多半
acid|酸 adj. 酸的；酸性的
elect|选举，推选；选择
cent|分；分币
arbitrary|随心所欲的；专断的
either|det,pron. （两者）任何一个
atlantic|大西洋的 n. 大西洋
actor|演剧的人
fever|发热，发烧；狂热
mostly|主要的，大部分
player|游戏的人；比赛者
swell|膨胀；增长；隆起
experience|经验，感受；经历
creative|创造性的，创作的
perfect|完美的；完全的
affection|慈爱，爱；爱慕
largely|大部分；大量地
extent|程度；广度；范围
better|较好的 adv. 更好地
disappear|消失；不见；失踪
motivate|促动；激励，激发
moreover|再者，加之，此外
regulate|管理，控制；调整
respectively|各自地，分别地
exit|出口；退场 v. 退出
chairman|主席；议长，会长
journal|日报，杂志；日志
below|在…下面（以下）
belief|信念；信任，相信
minority|少数；少数民族
over|在…上方；超过
conversation|会话，非正式会谈
factory|工厂，制造厂
cherry|樱桃；樱桃树
consent|同意，赞成 v. 同意
else|其它，另外 adj. 别的
mouse|鼠，耗子
disk|圆盘，唱片；磁盘
legal|法律的；合法的
fundamental|基础的，基本的
liquor|酒
ancient|古代的；古老的
pillow|枕头
grip|握紧，抓牢 n. 紧握
limitation|限制；限度，局限
chief|首席的；主要的
dark|暗的；黑色的
stoop|俯身；弯身 n. 曲背；驼背
parliament|议会，国会
weld|焊接，熔接 n. 焊接点
hang|挂，悬；吊死
pacific|和平的 n. 太平洋
regulation|规则，规章；管理
against|倚在；逆，对着
blood|血，血液；血统
life|生命；一生；寿命
cannon|大炮，火炮；榴弹炮
evening|傍晚，黄昏，晚上
confine|禁闭；限制
ceiling|天花板，顶蓬
ashamed|惭愧（的）；羞耻（的）
just|正好；只是；刚才
necessity|必要性；必然性
mercury|水银，汞
materialism|唯物主义
let|允许，让；使
darling|亲爱的人；宠儿
billion|万亿（英）
frame|框架，框子；构架
cheek|面颊，脸蛋
incident|发生的事；事件
head|头；上端 v. 率领
acquaintance|熟人；认识；了解
fifty|五十，五十个
people|人；人民，民族
injection|注射；注入
fetch|拿来；请来，接去
indignant|愤慨的，义愤的
carpenter|木工，木匠
function|功能；职务；函数
transparent|透明的；易识破的
exposure|暴露；揭露；曝光
sightseeing|观光，游览
around|在…周围
everybody|每人，人人
cart|二轮运货马车
theoretical|理论（上）的
herd|兽群，牧群 v. 放牧
fatal|致命的
england|英格兰；英国
sportsman|运动员
intensity|强烈，剧烈；〔光、声等的〕强度
violet|紫罗兰
agree|同意；持相同意见
lens|镜头；透镜，镜片
attitude|态度，看法；姿势
dirt|尘，污物，污垢；土
assemble|集合，召集；装配
slender|细长的；微薄的
sticky|粘性的；胶粘的
drawer|抽屉
dormitory|集体寝室；宿舍
ray|光线；射线，辐射线
delicious|美味的；怡人的
admit|承认；准许…进入
thread|线；丝；螺纹；头绪
poet|诗人
somehow|由于某种原因
mate|伙伴，同事；配偶
character|性格；角色；特性
across|横过；在…对面
organ|器官；管风琴；机构
gesture|姿势，手势；姿态
equality|等同，平等；相等
landlady|女房东；女地主
attend|出席；照顾，护理
proof|证据；证明；校样
cover|盖；包括 n. 盖子
fasten|扎牢，扣住
push|推；鼓励；敦促；逼迫
rib|肋，肋骨
light|轻的；少量的
stir|搅动；搅和；搅拌
earthquake|地震；大震荡
concentration|专注；集中；浓度
make|做，制造；使
wind|绕，缠绕
guilty|内疚的；有罪的
blaze|火；闪光 v. 燃烧
invest|投资；投入
cloudy|多云的；云一般的
grandson|孙子，外孙子
feeling|感觉，知觉；感情
trap|陷阱；诡计 v. 诱骗
race|比赛，竞赛，竞争
overlook|忽略；未注意到；眺望
spade|铲，铁锹
whistle|口哨 v. 吹口哨
action|行动；作用；功能
bolt|插销；螺栓 v. 闩门
drug|药，药物，药材
nitrogen|氮
listen|听，留神听；听从
murderer|杀人犯，凶手
evidence|根据；证据，证人
inhabitant|居民，住户
instead|代替，顶替；反而
alike|相像；十分相似
lesson|功课，课；课程
medium|媒质 adj. 中等的
lest|以免；惟恐
cancel|取消，撤销
butter|黄油；奶油
pill|药丸，丸剂
fairly|相当；公平地
horn|号角；喇叭；角
melt|融化
preposition|前置词，介词
fruitful|多产的；肥沃的
middle|中部 adj. 中部的
leap|跳，跃 n. 跳跃
million|百万 n. 许多
know|知道；认识；通晓
biology|生物学
voluntary|自愿的，志愿的
acquire|取得；获得；学到
independent|独立的；自主的
wheel|轮，车轮
hole|洞；孔眼；裂开处
symbol|象征；符号，记号
curious|好奇的；稀奇古怪的
bay|湾
forbid|禁止，不许；阻止
refer|谈到
finally|最后
nylon|尼龙，耐纶
ambition|雄心，抱负，野心
electric|电的，电动的
velocity|速度
relax|使松弛
golf|高尔夫球
bone|骨，骨骼
glory|光荣；荣誉的事
interpret|口译；解释，说明
want|需要；缺乏
mood|心情，情绪；语气
coach|长途公共汽车
examination|考试；检查，细查
kindness|仁慈，好意
terror|恐怖，惊骇
heroine|女英雄；女主角
cricket|板球；蟋蟀
retreat|（被迫）退却；后退
curve|曲线；弯 v. 弄弯
structural|结构的，构造的
via|经过；通过
misunderstand|误解，误会，曲解
pond|池塘
precaution|预防；警惕
shore|滨，岸
autumn|秋，秋季
prospect|展望；前景，前程
question|问题；疑问
front|前面的 n. 前部
broadcast|广播，播音
background|背景，经历；后景
appearance|外观；出现，来到
fur|软毛；毛皮，裘皮
pronoun|代词
coarse|粗的，粗糙的
clarify|澄清，阐明
remote|相隔很远的；冷淡的
investigation|调查，调查研究
boat|小船，艇
attractive|有吸引力的
occupy|占领；占，占有
agony|极度痛苦
platform|站台；讲台；平台
communism|共产主义
not|不，没有
intensive|加强的；精耕细作的
maybe|大概，或许；也许
disgust|厌恶，憎恶
utilize|利用
protection|保护
connect|连接，连结；联系
cancel|取消， 撤销； 删去
explosive|爆炸的； 极易引起争论的 n. 炸药
numerous|众多的
govern|居支配地位， 占优势 vt. 统治，治理，支配
analyse|分析； 分解； 解析
discourage|使泄气， 使灰心； 阻止， 劝阻
resemble|像， 类似于
remote|遥远的； 偏僻的； 关系疏远的； 脱离的； 微乎其微的； 孤高的， 冷淡的； 遥控的
salary|薪金， 薪水
pollution|污染， 污染物
pretend|装作， 假装
kettle|水壶
wreck|失事；残骸；精神或身体已垮的人 vt. 破坏
drunk|醉的； 陶醉的
calculate|计算； 估计； 计划
persistent|坚持的， 不屈不挠的； 持续不断的； 反复出现的
sake|缘故， 理由
conceal|把…隐藏起来， 掩盖， 隐瞒
audience|听众， 观众， 读者
meanwhile|与此同时
possess|占用， 拥有
competent|有能力的， 能胜任的
investment|投资， 投资额； 投入
neutral|中立的； 中性的
scratch|抓，搔，扒；刮，擦；刻出 n. 抓痕， 划痕； 抓， 搔， 刮
optional|可以任选的
require|需要； 要求； 命令
circular|圆的；循环的；兜圈子的 n. 通知， 通告
analysis|分析， 分析报告； 分解； 解析
click|发出咔嗒声；点击 n. 咔嗒声
fashionable|流行的， 时髦的
devise|设计， 发明
apparent|表面上的， 明显的
journalist|新闻工作者， 新闻记者
exposure|暴露， 揭露； 曝光
temper|韧度；心情，情绪 vt. 调和， 使缓和； 【冶】使回火
protective|保护的， 防护的
sideways|adv&adj. 从一边， 向一边； 在一边； 斜着， 侧身
multicultural|融合多种文化的
object|反对， 不赞成 n. 实物， 物体； 目的， 目标； 对象， 客体； 宾语
humble|谦逊的； 地位低下的； 简陋的
chapter|章， 回， 篇
harbour|海港，港口 vt. 庇护； 心怀
independent|独立的， 自主的； 无偏见的； 不相关联的
carriage|客车厢， 四轮马车
cliff|悬崖， 峭壁
infinite|无限的； 无穷的
concede|承认， 承认…为真； 承认失败； 允许， 让予； 让步， 认输
elect|选举， 推选； 选择
weekly|每周 adj. 每周的
result|发生； 结果 n. 结果；成果；比分
golf|高尔夫球运动
selfish|自私的， 利己的
sexism|性别偏见， 性别歧视
commission|委任状；委员会；佣金，回扣；授权，委托 vt. 委任， 委托
headline|大字标题； 新闻提要
connect|连接， 结合， 联系； 给…接通电话
rational|理性的， 理智的； 合理的
policy|政策， 方针； 保险单
editorial|编辑的，主笔的，编者的；社论的，社论式的 n. 社论， 重要评论
resume|重新开始， 继续， 恢复 n. 摘要， 概要； 简历
rebuild|重建， 改造； 复原
committee|委员会， 全体委员
namely|即， 也就是
artistic|艺术的， 艺术家的； 富有艺术性的， 精美的； 精彩的
union|工会， 联盟； 联合， 团结； 一致
plentiful|丰富的， 充足的； 大量的
halt|停止，立定 n. 停住
component|组成的， 构成的 n. 组成部分，部件，组件
consultant|顾问； 会诊医师， 专科医生
sunset|日落； 晚霞
obvious|明显的
illustration|说明， 图解， 例证
disguise|假扮，化装，伪装；掩盖，掩饰 n. 用来伪装的东西； 伪装， 掩饰
wrap|裹，包，捆 n. 披肩
surgery|外科， 外科手术； 手术室
liberal|心胸宽大的， 慷慨的； 自由的， 自由主义的
violent|暴力引起的， 暴力的； 猛烈的， 剧烈的
harmony|调和， 协调， 和谐
resolve|n&v. 解决， 解答； 决定， 决意
chill|变冷，感到冷 n. 寒冷， 寒气； 风寒， 寒战
confront|迎面遇到， 遭遇； 勇敢地面对， 正视； 使对质， 使当面对证
dominate|拥有优势 vt. 在…中占首要地位；支配，统治，控制；耸立于，俯视
imitate|模仿， 仿效， 仿制
faithful|忠诚的； 如实的； 尽职的
reproduce|复制， 再现； 繁殖， 生殖
institution|协会； 制度， 习俗
pad|垫，衬垫；便笺本；发射台，直升机起落场 vt. 填塞
provocation|激怒， 刺激； 挑衅， 挑拨
ambition|雄心， 抱负； 野心； 期望得到的东西
scholarship|奖学金； 学问， 学识
exceed|超过， 胜过， 超出
besides|而且 prep. 除…之外
preposition|介词
enlarge|扩大， 扩展， 放大
implement|工具， 器具， 用具 vt. 使生效， 履行， 实施
export|输出， 出口 n. 输出， 出口； 输出品， 出口额
christ|基督， 救世主
murder|谋杀，凶杀；谋杀罪 v. 谋杀；杀害
pat|非常恰当的， 适时的 n. 轻拍
fantasy|想象， 幻想； 想象的产物
horsepower|马力
visibility|可见度， 能见度； 可见性， 明显性
invitation|邀请， 招待； 请柬； 吸引， 诱惑
paw|用爪子抓， 用蹄扒； 翻找 n. 爪子
enormous|巨大的， 庞大的
moisture|潮湿， 湿气
toast|烤面包；祝酒，祝酒词 vt. 烘， 烤； 向…祝酒， 为…干杯
frustrate|使沮丧， 使灰心； 挫败， 使受挫折
external|外部的， 外面的
aside|在旁边， 到旁边
circumstance|情况， 条件； 境遇， 境况； 经济情况
revise|修订， 修改； 复习
authority|官方； 权力； 当权者， 行政管理机构； 权威， 专家
creature|创造物， 产物； 生物， 动物， 家畜
harm|n&vt. 伤害， 损害
semiconductor|半导体
rope|绳，索 vt. 用绳捆
provided|假如， 若是
instrument|仪器， 工具； 乐器
gasoline|汽油
indispensable|必不可少的， 必需的
medium|中等的 n. 媒体；媒介物，传导体
lens|透镜， 镜片， 镜头
wisdom|智慧， 才智； 名言
fatal|致命的， 命运的； 重大的， 决定性的
nowhere|任何地方都不
motive|动机， 目的
romantic|浪漫的； 多情的； 有浪漫色彩的， 传奇性的； 不切实际的， 空想的
motivate|作为…的动机； 激励， 激发
spoil|损坏，糟蹋；宠坏，溺爱；变质 n. 战利品， 掠夺物
airline|航空公司； 航线
multiply|增加， 繁殖； 乘
ridge|脊， 山脊； 垄， 埂， 脊状突起
pilot|试验性的， 试点的 n. 引航员；飞行员 vt. 驾驶；为引航；试验，试用
umbrella|伞， 雨伞
approval|赞成， 同意， 批准
mobile|运动的； 流动的； 多变的
perform|做， 履行， 完成； 表演， 演出； 工作情况， 表现
multiple|复合的，多重的，多样的 n. 倍数
peak|达到高峰， 达到最大值 adj. 最大值的，高峰的 n. 山顶，顶点
evolution|进化， 演化， 发展
portrait|肖像， 画像
halfway|半路地； 在中途， 在半途 adj. 中途的；部分的；不彻底的
expose|使接触； 揭露
concentrate|全神贯注，全力以赴；集中，聚集；浓缩 n. 浓缩物， 浓缩液
magnet|磁铁， 磁体； 有吸引力的人或事物
explosion|爆炸， 爆发， 炸裂； 激增， 扩大
weld|n&vt. 焊接， 熔接
up-to-date|直到最近的， 现代的； 跟上时代的
complaint|抱怨， 怨言； 控告
translation|翻译； 译文， 译本
cancer|癌， 癌症； 肿瘤
personnel|人员， 员工
hopeless|没有希望的， 绝望的
outlook|观点， 看法； 展望， 前景
fountain|泉水； 喷泉； 源泉
offense|犯规， 违法行为； 冒犯， 得罪
breadth|宽度； 幅度， 幅面
catalog|目录，目录册；一系列 vt. 将…编入目录， 将编目
channel|海峡， 水道， 航道； 渠道， 途径； 频道
focus|聚焦；集中 n. 焦点； 中心
invisible|看不见的， 无形的
entire|全部的， 整个的
pea|豌豆
pill|药丸
wrist|腕， 腕关节
approach|向…靠近 n. 靠近
myth|杜撰出来的人； 神话
flour|面粉； 粉， 粉状物质
implication|含意， 暗示， 暗指； 卷入， 牵连
camel|骆驼
fierce|凶猛的； 狂热的
bump|碰，撞；颠簸着前进 n. 碰撞， 猛撞； 肿块； 隆起物
reservation|预订； 保留； 犹豫； 保留地
per|每， 每一
proceed|继续进行； 行进， 前进
considering|鉴于， 考虑到， 顾及
corporation|公司， 企业， 社团
loyalty|忠诚， 忠心
bulb|电灯泡， 球状物
dismiss|不再考虑； 解雇， 解散； 驳回
propose|提议， 建议， 提出； 提名， 推荐； 打算， 计划； 求婚
intelligence|智力； 理解力； 情报
reform|n&v. 改革， 改良， 改造； 改正， 改过自新
draught|穿堂风，冷风 adj. 〔啤酒〕桶装的，散装的
daylight|白昼， 日光， 黎明
install|安装， 设置； 使就职， 任命
integration|综合
indication|指示， 表示， 表明； 象征， 迹象
bulk|变得越来越大； 使更大 n. 物体；体积；大批
coach|长途公共汽车；教练，指导；旅客车厢 vt. 训练， 指导， 辅导
despair|绝望 v. 绝望，感到无望
champion|冠军， 得胜者； 捍卫者， 拥护者
gum|口香糖； 树胶
circuit|电路， 线路； 环行， 巡行
pine|消瘦， 衰弱； 痛苦， 悲哀； 渴望 n. 松树，松木
magnificent|宏伟的， 壮丽的； 华丽的； 极好的
guy|家伙， 伙计
respectively|各自地， 各个地， 分别地
protection|保护， 防护
pint|品脱
restrict|限制， 约束， 限定
instant|立即的； 紧急的； 可以速食的 n. 瞬间
conjunction|接合， 连接， 联合； 连词
peer|仔细看， 费力地看 n. 同龄人，同等地位的人；贵族
orderly|整洁的； 有秩序的
costly|昂贵的， 价值高的
roast|烤，炙，烘 adj. 烤过的， 烘过的 n. 烤肉
violence|猛烈， 激烈； 暴力
succession|连续； 一连串； 接替， 继任， 继承
accordingly|因此， 所以； 照着
consequence|结果， 后果； 重要， 重大
product|产品， 产物； 乘积
particularly|特别， 尤其
dominant|占优势的， 支配的， 统治的； 居高临下的， 高耸的
heading|标题， 题词， 题名； 新闻提要
lover|爱好者； 情人
vinegar|醋
intellectual|智力的 n. 知识分子
cheat|欺骗；作弊；哄，行骗 n. 欺骗， 欺骗行为； 骗子
framework|框架， 结构； 准则； 体系
undoubtedly|毋庸置疑地， 肯定地
infect|传染， 感染； 影响
tide|潮， 潮汐； 潮流， 趋势
prohibit|禁止， 不准
bacteria|细菌
minor|辅修 adj. 较小的，较少的；次要的 n. 未成年人；辅修科目
arrow|箭， 箭状物； 箭头符号
cop|警察
fuel|加燃料； 加油 n. 燃料，燃料剂 vt. 给…加燃料；刺激
hostile|敌方的； 不友善的
aeroplane|飞机
manner|方式； 态度； 风度； 礼貌， 规矩
employee|受雇者， 雇员， 雇工
associate|结合； 交往 adj. 副的 vt. 把…联系在一起；使联合 n. 伙伴，同事
pray|祈祷， 祈求； 请求， 恳求
lad|男孩， 小伙子
crawl|爬， 爬行； 缓慢地行进
identical|完全相同的， 同一的
lag|走得慢 n. 落后
towel|毛巾， 手巾
charity|救济金， 施舍物； 慈善团体， 慈善事业； 宽大， 宽容
academic|学院的； 学术的； 纯理论的， 不切实际的
function|运作， 运行 n. 功能；职务，职责
employer|雇佣者， 雇主
pit|地洞，坑；煤矿，矿井 vt. 使有坑
lap|舔； 拍打 n. 膝部；一圈，一段
mineral|矿物， 矿石， 矿物质
stock|常用的， 常备的 n. 原料，库存品；股本，公债；世系，血统；汤汁；家畜，牲畜 vt. 储备
representative|有代表性的， 典型的 n. 代表，代理人
suspend|暂停， 终止； 吊， 悬
pigeon|鸽子
well-known|众所周知的， 著名的
beneath|在下方， 在底下 prep. 在…下方；低于，次于；在…掩盖下；连…也不值得，有失…的身份
terror|恐怖， 惊骇； 引起恐怖的人或事
comparison|比较， 对照； 比拟， 比喻
surge|蜂拥而出；洋溢，奔放；汹涌，奔腾 n. 大浪， 波涛； 高涨； 汹涌
lest|唯恐， 以免
heroic|英雄的； 英勇的
sway|摇，摇动；动摇 n. 摇摆， 摇动； 起支配作用的影响
basis|基础， 根据； 原则
tutor|当…导师， 当…家庭教师 n. 导师；家庭教师，私人教师
senator|参议员
adventure|奇遇； 冒险， 冒险活动
successive|连续的， 接连的
condition|状况， 状态； 环境
thirsty|渴的； 渴望的
ceremony|典礼， 仪式， 礼节
obligation|义务， 责任
improve|变得更好； 改善； 提高
gym|体育馆； 健身房
rarely|很少， 难得
evil|坏的 n. 邪恶，祸害
governor|州长； 主管人员； 理事， 董事
twist|缠绕，盘绕；转动，旋动；捻，搓；歪曲，曲解；扭歪，扭伤；曲折前进；转身 n. 扭弯； 转折， 转变； 弯曲， 曲折处
locate|探明， 找出； 把…设置在， 使…坐落于
unite|联合， 统一
lavatory|盥洗室， 厕所
exterior|外部的；对外的 n. 外部， 外表
technique|技术， 技巧， 技能
combat|战争，斗争，格斗 vt. 与…斗争， 与…战斗
troop|成群结队而行 n. 军队，部队；一群，大量
scenery|风景， 景色； 舞台布景
unity|单一， 统一， 团结； 和睦， 协调
effective|有效的； 有影响的
pursue|继续； 从事； 追赶， 追踪； 追求
similarly|类似地， 相似地
convey|表达， 传递； 运送， 输送
muscle|肌肉， 体力； 力量， 实力
design|设计；预定，指定 n. 设计， 构想； 图样； 企图
extra|特别地 adj. 额外的；特别的 n. 额外的事物， 额外费用
generous|慷慨的； 宽厚的； 大量的
victim|牺牲者， 受害者
possibility|可能； 可能的事
lane|小路； 跑道； 航道， 航线
garlic|大蒜
chief|主要的，为首的；总的 n. 首领， 长官； 酋长， 族长
accord|相符合； 相一致 n. 一致，符合；谅解，协议 vt. 使符合；使一致；调节；授予，赠与，给予
aircraft|飞机， 飞行器
automatic|自动的，机械的；不假思索的，无意识的；必然的，自然的 n. 自动手枪； 有自动装置的汽车
doubtful|难以预测的； 怀疑的
despite|不管， 不顾
opening|开首的，开始的 n. 口子， 洞， 孔； 开始； 空缺
industrial|工业的， 产业的
obey|顺从， 服从
conduct|举止， 行为； 指导； 管理； 实施 vt. 进行； 管理， 指挥， 引导； 传输， 传导
stable|稳定的，不变的；沉稳的，持重的 n. 厩， 马厩， 牛棚
lamb|羔羊， 小羊； 羔羊肉
pillow|枕头
harness|治理；给上挽具 n. 马具， 挽具
fantastic|极好的， 极出色的， 了不起的； 极大的； 难以相信的； 异想天开的， 不实际的； 奇异的， 古怪的
sketch|绘…的略图， 画…的素描； 概述 n. 略图；梗概；素描，速写
tidy|整洁的，整齐的 v. 整洁， 整齐
respond|回答， 答复； 作出反应， 响应
incident|发生的事， 事件
maintenance|维持； 保养； 抚养费
marry|娶， 嫁； 为…证婚； 结婚， 结合
decay|腐烂；衰败 n. 腐烂
absorb|吸收； 吸引…的注意， 使全神贯注； 把…并入， 同化
supply|n&vt. 供给， 供应
concern|关切的事，有关的事；关心，挂念；关系，关联；公司，企业 vt. 涉及， 有关； 使关心， 使担心
circulate|循环， 流通； 流传， 散布， 传播
liberty|自由； 许可， 准许； 过于随便， 放肆
liable|易于…的； 可能的
cargo|船货， 货物
confidential|秘密的， 机密的； 亲信的
drift|漂流，漂泊 n. 漂流； 大意， 主旨； 趋势
element|成分， 要素， 元素； 基础， 纲要； 自然力
chaos|混乱， 紊乱
mankind|人类
abundant|丰富的， 富裕的； 大量的， 充足的
pace|踱步 n. 步，步速；速度；节奏
exclaim|呼喊， 惊叫
probable|很可能的， 大概的
forecast|预测， 预报 n. 预测，预报
uncover|揭露， 暴露； 揭开…的盖子
recognize|认出， 识别； 承认； 赏识， 表彰， 报偿
pack|捆扎，把…打包；使挤在一起，塞满 n. 包， 小盒
restraint|抑制， 限制， 克制； 约束措施， 约束条件
input|输入；投入的资金；输入的数据 vt. 把…输入计算机
cue|暗示，信号；提示 vt. 提示； 暗示
volt|伏特， 伏
reality|现实， 实际； 真实
stereotype|陈规，老套，固定的模式；铅版 vt. 把…浇铸成铅版； 对…形成固定看法
enroll|入学，加入 vt. 招收， 吸收
offend|冒犯， 伤害…的感情； 使厌恶； 违反
molecule|分子
resign|辞职 vt. 辞去， 放弃； 使听从， 使顺从
bathe|洗澡； 游泳
workman|工人， 劳动者， 工匠
sophisticated|老于世故的； 高级的； 精密的， 复杂的； 高雅的
sunrise|日出； 朝霞
entertainment|娱乐， 文娱节目， 表演会； 招待， 款待， 请客
document|公文，文件；证件 vt. 用文件等证明
starve|挨饿， 饿死
battery|电池， 蓄电池； 排炮， 炮组； 一系列， 一套
chase|追逐， 追赶； 追求
accident|意外， 事故
marine|海的， 海生的； 海事的， 海军的， 海运的 n. 海军陆战队士兵
clay|黏土， 泥土； 肉体
anyway|无论如何， 至少； 不论以何种方式， 无论从什么角度
promote|促进， 增进， 发扬； 提升； 宣传， 推销
routine|例行的， 常规的 n. 例行公事，惯例，惯常的程序
attack|攻击，打击；突然发作 vt. 攻击， 进攻
humour|幽默， 诙谐， 幽默感
divorce|离婚； 分离， 脱离 n. 离婚，离异
currency|通货， 货币； 通行， 流行
canal|运河， 沟渠； 管
attach|缚， 系， 贴； 附加； 使依恋， 使喜爱； 使附属； 认为有
distribute|分发， 分送； 分布
ankle|踝， 踝关节
convict|证明…有罪， 宣判…有罪 n. 囚犯
legislation|法律， 法规； 立法， 法律的制定
clause|条款； 从句， 分句
quiz|智力竞赛，问答比赛；小测验 vt. 考查， 盘问
participate|参与， 参加； 分享
ingredient|组成部分， 成分； 原料； 要素， 因素
surplus|过剩的， 多余的 n. 过剩，剩余，盈余
correspondence|信件， 函件； 通信， 通信联系； 符合， 一致， 相似
refresh|振作精神， 恢复活力
librarian|图书馆管理员
intimate|亲密的；个人的 n. 至交， 密友 vt. 暗示， 提示
reporter|记者
declaration|宣布， 宣告； 宣言， 声明； 申报
disclose|揭示； 透露
religion|宗教， 宗教信仰
diagram|图解， 图表， 简图
claw|抓， 撕 n. 爪，脚爪，螯
torture|拷问；折磨 vt. 拷打
prayer|祷告， 祈祷； 祷文； 祈求， 祈望
tragedy|悲剧， 惨事， 惨案； 悲剧艺术
charm|迷人的特性，魅力；符咒，咒文 vt. 吸引， 迷住
clap|拍手，轻拍 n. 拍手， 鼓掌
purple|紫的 n. 紫色
quit|停止， 放弃； 离开， 辞
economical|节约的； 经济学的
prosperous|繁荣的， 兴旺的
polish|磨光；修改，润色，使优美 n. 擦光剂
cabinet|橱， 柜； 内阁
chart|图表；航海图 vt. 用图表表示， 在图上表示
optical|眼的， 光学的， 视觉的
fashion|样子， 方式； 时尚； 流行款式
insurance|保险， 保险费
preface|序言， 前言， 引言
principle|原则， 原理， 道义； 基本信念， 信条
lid|盖子， 盖
tedious|冗长乏味的， 沉闷的
source|河的源头， 根源； 来源， 出处
secure|安全的，可靠的；牢固的，稳固的；无忧虑的，安心的 vt. 得到， 获得； 使安全， 保卫； 缚牢
domestic|本国的； 家庭的； 驯养的
deception|欺骗； 诡计， 骗局
basically|基本上， 从根本上说
donation|捐款， 捐赠物； 捐赠， 赠送
avenue|林荫道， 道路， 大街
immense|巨大的； 极好的
budget|规划，安排；编预算 adj. 低廉的， 收费公道的 n. 预算，预算拨款
given|规定的，特定的；假设的；已知的；有癖好的，有倾向的 prep. 考虑到
hay|干草
chest|胸腔， 胸膛； 箱子
tension|紧张， 不安； 拉紧； 张力， 拉力
definite|明确的， 肯定的
reflection|映像， 倒影； 反射； 反映， 表达； 非议； 沉思， 反省
ultimate|最后的，最终的 n. 终极， 顶点
campus|校园， 学校场地
adapt|使适应； 改编
solicitor|律师， 法律顾问
cheerful|快乐的， 愉快的； 使人感到愉快的
merit|长处，优点，价值；功劳，成绩 vt. 值得， 应受
misunderstand|误解， 误会
guilty|内疚的； 有罪的
measure|测量，度量；衡量 n. 分量； 尺寸； 量具； 计量单位； 量度， 测量； 措施， 办法
overall|全面的， 总体的， 全部的
receipt|发票， 收据； 收入， 进款； 收到， 接到
assume|假定， 假设， 臆断； 承担， 担任； 呈现
pepper|胡椒，胡椒粉 vt. 在…上撒； 使布满
plural|复数的 n. 复数
doctoral|博士的
concept|概念， 观念， 设想
resistant|抵抗的， 抗…的， 耐…的
effort|努力， 努力的成果
video|录像的；电视的 n. 录像
disaster|灾难， 灾祸， 天灾； 彻底的失败
agriculture|农业， 农学
weapon|武器， 兵器
grocer|食品商， 杂货商
stare|n&vi. 盯， 凝视
painful|疼痛的， 引起疼痛的； 困难的； 令人不快的
vote|投票； 表决 n. 票，选票；选举，投票，表决；表决结果，投票总数
steady|稳定 adj. 稳的，平稳的；稳定的，持续的；稳固的
enhance|提高， 增加， 加强
enclose|围住， 圈起； 附上； 把…装入信封
convention|习俗， 惯例； 公约； 会议
disease|病， 疾病； 不健全； 弊端
center|圆心， 正中； 中心
suspicion|怀疑， 疑心， 猜疑； 一点儿， 少量
purchase|买，购买 n. 购买； 购买的物品
refusal|拒绝
technician|技术员， 技师
generic|【生物】 属的， 类的； 一般的， 普通的
genius|天才， 天赋， 天资； 天才人物
alike|一样地， 相似地； 同样程度地 adj. 同样的，相同的
fund|资金，基金；存款 vt. 为…提供资金
gravity|重力， 引力； 严重性； 严肃， 庄重
typical|典型的， 代表性的
quotation|引文， 引语， 语录； 报价， 牌价， 行情
finance|筹措资金 n. 财政，金融；财源，财务情况
studio|画室， 摄影室； 播音室， 录音室， 摄影棚
tray|盘， 托盘， 碟
downward|向下地 adj. 向下的
cabbage|洋白菜， 卷心菜
regulate|管理， 控制； 调整， 调节
palm|手掌， 掌状物； 棕榈树
hydrogen|氢
infant|婴儿的； 幼稚的 n. 婴儿
hen|母鸡， 雌禽
whoever|谁； 无论谁； 究竟是谁
carbon|碳
unload|卸， 卸货； 下客； 退出子弹； 卸下胶卷
payment|支付， 支付的款项
specifically|特别地， 特定地； 明确地， 具体地
controversial|引起争论的， 有争议的
attain|达到， 获得， 完成
trap|陷阱，捕捉器；圈套，诡计；困境 vt. 设陷阱捕捉； 诱骗
gallery|画廊， 美术馆； 楼座； 旁听席； 回廊， 走廊
hardware|五金器具； 硬件
deputy|副职， 副手； 代表， 代理人
warmth|暖和， 温暖； 热烈， 热情， 热心
supreme|最高的， 最大的； 极度的， 最重要的
ambulance|救护车； 野战医院
priority|优先， 重点； 优先考虑的事
slope|倾斜 n. 倾斜；斜面
philosophy|哲学， 哲理， 人生哲学
preventive|预防性的
creative|创造性的， 创作的
junior|年少的；资历较浅的 n. 晚辈； 三年级学生
allocate|分配， 分派， 把…拨给
provide|提供， 供给
standpoint|立场， 观点
worship|礼拜；崇拜；信奉 vt. 崇拜
lawn|草地， 草坪， 草场
primary|首要的， 主要的； 基本的； 最初的， 初级的
log|原木，木料；航海日志 vt. 正式记录
solar|太阳的， 日光的； 太阳能的
consume|消费， 吃完， 喝光； 毁灭； 使着迷， 充满
formation|形成， 构成， 形成物； 队形， 排列
layer|层， 层次
triangle|三角
accidental|偶然的， 意外的
assure|使确信； 确保， 向…保证
consult|请教； 查阅； 商议
theme|主题， 题目
smash|粉碎，打烂；狠打，猛击；破灭，失败；猛撞，猛冲 n. 破碎 ； 猛击， 猛撞； 轰动的演出， 巨大的成功
merely|仅仅， 只不过
contradiction|矛盾， 不一致； 否认， 反驳
fuss|n&vi. 忙乱； 大惊小怪， 小题大做； 烦恼， 过于忧虑
wealth|财富， 财产； 丰富
editor|编辑， 编者， 校订者
barrel|桶； 圆筒； 枪管
means|方法， 手段， 工具； 金钱， 财产
desire|渴望；要求 n. 愿望； 欲望
survive|活下来， 幸存 vt. 从…逃出，幸免于；从中挺过来；比…活得长
efficient|效率高的； 有能力的
initial|最初的，开始的 n. 首字母
unfortunately|不幸地
consistent|坚持的， 一贯的； 一致的， 符合的
reverse|撤销，推翻；反向，倒转；彻底改变 adj. 反向的， 相反的， 倒转的 n. 相反，对立面；反面，背面，后面；挫折，逆境
heterogeneity|异种， 异质， 不同成分
sword|剑， 刀
permanent|永久的， 固定的
barely|仅仅， 只不过， 几乎不
summarize|概括， 概述， 总结
chap|小伙子， 男人， 家伙
facility|设备； 容易； 场所
beam|梁，横梁；束，柱；笑容，喜色 vt. 面露喜色； 定向发出， 播送
alliance|结盟， 联盟
civilization|文明， 文化； 开化
fiction|小说； 虚构， 杜撰
possession|有， 所有； 所有物
replace|代替， 取代； 更换， 调换； 把…放回原处
appointment|任命； 约定； 约会； 委任的职位
hip|臀部， 髋部
merry|欢乐的， 愉快的
dam|水坝，水堤；障碍物 vt. 筑堤挡住
pessimistic|悲观的
commander|司令官， 指挥员
bloom|开花 n. 花，开花，开花期；青春焕发
major|较大的；主要的；重大的 n. 少校； 专业
zone|地区， 区域， 范围
emphasis|强调； 重点， 重要性
interrupt|打断， 打扰， 中断
feasible|可行的， 可能的
prescribe|开； 吩咐采用； 规定， 指定
potential|潜在的，可能的 n. 潜力， 潜能
bean|豆， 蚕豆
accustomed|惯常的， 习惯的
combination|结合， 联合； 化合
obtain|获得； 通用， 流行； 存在
turbine|叶轮机， 汽轮机
repeatedly|一再， 再三， 多次地
curiosity|好奇， 好奇心； 奇物， 奇事， 珍品
gross|总的； 严重的； 粗俗的； 臃肿的
workshop|车间， 作坊， 创作室； 研讨会， 讲习班
resist|抵抗， 反抗， 抵制； 抗， 耐； 忍住， 拒受…的影响
liter|升
format|设计，安排；格式，样式，版式 vt. 使格式化
sacrifice|牺牲，舍身；献祭，供奉 n. 牺牲； 供奉； 祭品
illegal|不合法的， 非法的
stimulate|刺激， 激励， 激发
formal|正式的， 礼仪上的
congratulate|祝贺， 向…道喜
rainbow|虹， 彩虹
soak|浸， 泡
soar|猛增， 剧增； 高飞， 升腾； 高涨； 高耸， 屹立
salesman|售货员， 推销员
interference|干涉， 干预， 阻碍
fibre|纤维， 纤维质
sustain|保持， 使持续下去； 供养， 维持； 支持， 支撑； 经受， 遭受
entertain|使欢乐； 招待， 请客
altitude|海拔， 高度； 高处
classify|把…分类， 把…分级
ease|容易；舒适 vt. 缓和
critical|决定性的； 批评的
colony|殖民地； 侨居地， 聚居地； 群体， 集群
mathematics|数学
wagon|四轮马车， 大篷车； 铁路货车， 客货两用车
elsewhere|在别处， 向别处
penetrate|透入， 渗入， 进入； 刺穿； 洞察， 了解
principal|最重要的，主要的 n. 负责人， 校长； 资本， 本金； 主要演员， 主角
tend|照管， 照料， 护理 vt. 易于，往往会；趋向，倾向
exceedingly|极端地， 非常
specimen|样本， 标本， 样品
relief|轻松， 宽慰； 缓解； 调剂， 消遣； 接替
dimension|尺寸， 尺度； 方面， 特点； 面积， 规模
introduction|介绍， 引进； 引言
deserve|应受， 值得
process|过程；制作法；程序 vt. 加工； 办理
philosopher|哲学家， 哲人
restore|恢复， 使回复； 修复， 整修； 归还， 交还
therapy|治疗， 理疗
alternative|两者选一的， 供选择的； 另类的 n. 替换物，选择；选择的自由
banner|横幅； 旗， 旗帜
concentration|集中； 专注， 专心； 浓缩， 浓度
encounter|遭遇，遇到 n. 遭遇
soda|碳酸钠， 纯碱； 汽水， 苏打水
colleague|同事， 同僚
gratitude|感激， 感谢， 感恩
approve|赞成， 称许； 批准
interaction|相互作用， 干扰
chew|咀嚼， 嚼碎
interfere|干涉， 干预， 妨碍
apartment|一套公寓房间
account|说明原因； 占 n. 记述；解释；账目
uneasy|心神不安的， 忧虑的
tolerate|忍受， 容忍； 容许， 承认
developmental|发展的
stack|堆，垛 vt. 堆积， 堆放于
underline|在…下面画线； 强调， 使…突出
innocent|清白的； 幼稚的； 没有恶意的
compassion|同情， 怜悯
alphabet|字母表， 字母系统
parliament|议会， 国会
evaluation|评价； 估计
crack|爆裂； 噼啪地响； 打， 击 n. 裂缝，裂纹；破裂声
bind|捆绑， 包扎； 装订； 约束； 使结合， 使黏合
trim|整齐的 vt. 使整齐
appreciate|重视， 赏识； 领会， 体会； 感谢； 增值
dental|牙齿的， 牙科的
predictable|可预料的
diverse|不一样的， 相异的； 多种多样的
railway|铁路
cube|清澈透明的 n. 立方形，立方
rally|集合， 团结； 恢复， 重新振作 n. 集会；公路汽车赛
prime|首要的；最好的 n. 青春；全盛时期 vt. 使准备好
happen|发生； 碰巧， 恰好
festival|节日； 音乐节
mild|温柔的； 温暖的； 轻微的
profile|侧面；人物简介；轮廓，形象；姿态，引人注目的状态 vt. 为…描绘； 写…的传略
loyal|忠诚的， 忠心的
preference|喜爱， 偏爱； 偏爱的事物； 优先
impact|影响， 作用， 冲击
opportunity|机会， 良机
active|活跃的， 积极的； 主动的； 起作用的
dorm|宿舍
whichever|pron&adj. 无论哪个， 无论哪些
court|法院， 法庭； 庭院； 宫廷； 球场
venture|冒险， 敢于 n. 风险投资，风险项目
mill|磨， 碾 n. 磨坊；碾磨机；制造厂，工厂
bucket|水桶， 吊桶； 铲斗
senior|资格较老的，地位较高的；年长的 n. 较年长者； 毕业班学生
dose|剂量， 用量， 一剂
route|路线， 路程
enthusiasm|热情， 热心， 热忱； 巨大兴趣
flexible|易弯曲的， 灵活的
adult|成年的； 成年人的， 适宜于成年人的 n. 成年人
attitude|态度， 看法； 姿势
relative|有关系的，相对的 n. 亲属， 亲戚
organ|器官； 机构； 管风琴； 新闻媒介
average|平均的；平常的 v. 平均 n. 平均数，平均
treatment|待遇； 治疗， 疗法； 对待， 处理
compare|比较， 对照； 把…比作
pluralism|多重性； 兼职， 兼任
influential|有影响的； 有权势的
shiver|n&vi. 战栗， 颤抖
bible|圣经
liquor|酒， 烈性酒
honourable|光荣的； 可敬的； 正直的
characteristic|特有的，典型的 n. 特性
transparent|透明的； 易识破的； 明显的， 清楚的
interior|内部的；内地的 n. 内部
rouse|惊起； 唤起； 唤醒
journal|日报， 杂志， 日志
grasp|抓紧，握紧；理解 n. 抓； 理解
involvement|连累； 包含
spark|发出火花 n. 火花，火星
unlike|不同的 prep. 不像…
assembly|立法机构； 议会； 集合； 集会的人们； 装配， 组装
hearing|听力， 听觉； 听力所及之距离； 意见听取会； 申辩的机会
acquisition|取得， 获得， 习得； 获得物， 增添的人
volcano|火山
rigid|严格的； 死板的； 刚硬的， 僵硬的
deadline|最后期限
so-called|所谓的， 号称的
grateful|感激的； 令人愉快的
chip|屑片， 碎片； 炸土豆条； 集成电路片， 集成块； 缺口， 瑕疵
chin|颏， 下巴
emotional|感情的， 情绪的
operational|运转的； 可使用的； 操作上的
staff|工作人员；参谋 vt. 为…配备人员
involve|使卷入， 牵涉； 包含， 含有
noticeable|显而易见的
assemble|集合， 召集； 装配
blast|爆炸，冲击波；一阵 vt. 炸
series|一系列， 连续； 丛书， 连续剧
complicated|复杂的， 难懂的
cultivate|耕作， 种植； 培养， 陶冶
maximum|最大的， 最高的， 顶点的 n. 最大量，顶点
thrive|兴旺， 繁荣， 旺盛
purse|钱包， 女用小提包
represent|作为…的代表； 表示， 象征； 描绘， 表现
compete|比赛， 竞争， 对抗
dialect|方言， 土语， 地方话
accountant|会计人员， 会计师
stocking|长袜
dim|昏暗的；朦胧的；模糊不清的 v. 变暗淡
emergency|紧急情况， 突然事件
dip|蘸，浸 n. 游一会儿泳
recreational|休养的； 娱乐的
faculty|才能， 能力； 系， 科； 全体教员
trail|痕迹，小径 vt. 跟踪， 追踪
passport|护照
prior|在前的； 优先的
considerate|考虑周到的， 体贴的， 体谅的
clue|线索， 暗示， 提示
legal|法律的； 合法的
bracket|括号 vt. 把…归为同一类
highway|公路， 大路
vanish|突然不见， 消失； 不复存在， 绝迹
signal|显著的， 重大的 n. 信号，暗号；标志，表示 vt. 发信号；标志着
sightseeing|观光， 游览
parcel|包裹，小包，邮包 vt. 分， 分配； 把…包起来， 捆扎
static|静的，静态的；静止的，停滞的 n. 静电
journey|旅行 n. 旅行，旅程
planet|行星
finally|最后； 决定性地
exhaust|使筋疲力尽；用尽；详尽论述 n. 排气装置； 废气
creep|爬行， 缓慢地行进
strap|带子 vt. 捆扎； 用绷带包扎
grape|葡萄， 葡萄藤
conviction|确信； 坚定的信仰； 说服， 信服； 定罪， 判罪
scholar|学者； 奖学金获得者
straw|稻草； 麦秆吸管， 吸管
regarding|关于
graph|图， 图表
vision|想象力； 梦幻； 视力， 视觉
accompany|陪伴， 陪同， 伴随； 为…伴奏
petrol|汽油
acceptance|接受； 承认； 容忍
relativity|相对论； 相关性
beneficial|有利的， 有益的
tackle|对付，处理；与…交涉；阻截，擒抱 n. 阻截， 擒抱； 用具， 钓具； 辘轳， 滑车
reckon|认为， 估计； 指望， 盼望； 测算， 测量
confusion|困惑， 糊涂； 混淆； 骚乱
occasion|场合，时刻；重大活动；时机；起因 vt. 引起
loan|n&v. 贷款， 借
virtual|实质上的， 事实上的， 实际上的
squeeze|挤；压榨，榨取；捏，握 n. 挤； 握手； 拮据， 紧缺
blank|空白的；茫然的，无表情的 n. 空白； 空白表格
landlord|地主， 房东； 店主
session|会议， 一届会期； 集会
additional|附加的， 追加的
worthy|有价值的， 值得的
endless|无止境的
expectation|期待， 期望， 预期； 前程， 成功的前景
title|标题， 题目； 称号， 头衔； 权利， 权益
mist|蒙上薄雾； 模糊 n. 薄雾
primarily|首先； 主要地
duration|持续， 持久
plantation|种植园， 人工林
ignore|不顾， 不理， 忽视
loaf|游荡， 闲逛 n. 面包
nuclear|核子的， 核能的， 核武器的； 核心的
reception|招待会， 欢迎会； 接受； 接待； 接收效果
outward|外面的； 外表的； 向外的
bloody|[用于加强语气]非常，很 adj. [用于加强语气]非常的；该死的；流血的；嗜杀的 vt. 血染
poetry|诗， 诗歌， 诗集
owner|物主， 所有人
vapour|蒸汽
sole|单独的， 唯一的 n. 脚底，鞋底，袜底
jury|陪审团； 评奖团
holy|神圣的， 圣洁的， 虔诚的
spelling|拼字， 拼法， 拼写法
relax|放松， 松弛； 放宽， 缓和
priest|神父， 牧师
monitor|班长；监视器，检测器；显示器 vt. 监听； 检测
permission|允许， 许可， 准许
grand|宏伟的； 重大的； 傲慢的； 派头大的； 绝佳的； 全部的
schedule|时刻表，日程安排表；清单，明细表 vt. 安排， 排定
postage|邮费， 邮资
tame|驯服的，顺从的；沉闷的，乏味的 vt. 制服， 控制并利用； 驯化， 驯服
material|物质的， 实体的； 肉体的； 重要的， 实质性的 n. 材料，素材
universe|宇宙， 世界； 领域， 范围
interpret|解释， 说明； 口译
spectacular|壮观的，引人注目的 n. 壮观的演出； 惊人之举
inherit|成为继承人 vt. 继承
peculiar|奇怪的， 古怪的； 特有的
blanket|毛毯， 毯子， 羊毛毯
grant|授予物；补助金 vt. 授予， 给予； 同意
injection|注射， 注入； 充满
envy|妒忌，羡慕；妒忌的对象 vt. 妒忌， 羡慕
hut|小屋， 棚屋
invincible|不能征服的， 无敌的
discount|折扣 vt. 将…打折扣； 不信； 漠视， 低估
convert|转变， 转化； 改变
construct|建造； 构思 n. 建筑物； 构想， 观念
attempt|尝试， 试图， 努力
thick|厚厚地 adj. 厚的，密的，浓的；不清楚的，口音重的
superficial|表面的， 肤浅的
division|分， 分配； 除法； 分歧； 分裂
executive|执行的 n. 执行者
navigation|航行， 航海， 航空； 导航， 领航
melt|融化； 熔化； 消散
hook|钩住 n. 钩，挂钩
stale|不新鲜的； 陈腐的， 过时的
balance|使平衡；称；权衡，比较 n. 天平； 平衡； 结存， 结欠
cigar|雪茄烟
action|行动； 已做的事； 作用， 功能； 情节
stadium|运动场， 体育场
whereas|然而， 但是， 尽管
pitch|投， 掷； 架设， 搭， 营； 颠簸 n. 球场；程度，强度；高度；音高；沥青 vt. 投掷；使猛然倒下；表达；把…定于特定程度；定调
kindness|仁慈， 好意
adoptive|收养关系的； 采用的
chop|砍，劈；切细 n. 排骨
electrical|电的， 电气科学的
statue|塑像， 雕像， 铸像
being|存在； 生物， 生命
sensitive|敏感的， 灵敏的， 神经过敏的； 容易生气的， 易受伤害的
protest|抗议， 反对 n. 抗议， 反对
classification|分类， 分级， 分类法； 类别， 级别
vacant|空的， 未被占用的； 空缺的； 茫然的， 空虚的
physicist|物理学家
afford|担负得起； 提供
underground|在地下，往地下；秘密地，不公开地 adj. 地下的；秘密的，不公开的 n. 地铁； 地下组织
curse|诅咒，咒骂 n. 天谴； 祸害， 祸根
impression|印象； 印记
baseball|棒球
interval|间隔， 间距； 幕间休息
evaluate|评价； 估…的价
machinery|机器， 机械
status|地位， 身份； 情形， 状况
shield|防护物，护罩；盾 vt. 保护， 防护
upset|心烦的， 苦恼的； 不适的 vt. 使心烦意乱，使苦恼，使不适；搅乱；弄翻，倾覆 n. 翻倒；搅乱；不安；不适
inference|推断结果， 结论； 推论， 推理， 推断
curve|弯曲 n. 曲线，弯，弯曲处
dot|点，圆点 vt. 打点于
skim|撇去， 掠过， 擦过； 浏览， 略读
phenomenon|现象
notify|通知， 告知， 报告
mention|n&vt. 提及， 说起
stream|流出， 涌出 n. 河，溪流；一股，一串
laundry|洗衣房， 洗衣店； 待洗的衣服， 洗好的衣服
accumulate|积累， 堆积
crime|罪， 罪行， 犯罪
heave|起伏，隆起；呕吐，恶心 vt. 举起，提起，拉起，拖；扔；发出 n. 举起； 起伏， 升降
leisure|空闲时间； 悠闲
nourish|提供养分， 养育
surround|围， 围绕； 圈住
mat|席子， 垫子
cigarette|香烟， 纸烟， 卷烟
torch|火炬， 火把； 手电筒
positive|确实的， 明确的； 积极的， 肯定的
favourite|特别受喜爱的 n. 特别受喜爱的人
menu|菜单
prospect|勘探， 勘察 n. 前景， 前途， 可能性； 景象， 景色； 可能成为主顾的人； 有希望的候选人
radar|雷达
refugee|难民
aluminium|铝
comparable|可比较的； 类似的； 比得上的
specialize|成为…专家； 专攻
rotate|旋转， 转动； 轮流
instance|例子， 实例， 事例
opera|歌剧
presumably|大概， 可能， 据推测
conscience|良心， 道德心
subject|题目； 学科； 主语 vt. 使隶属
practically|几乎， 简直； 实际上
recognition|认出， 识别； 承认； 赏识， 表彰， 报偿
cassette|盒式录音带
blade|刀刃， 刀片， 叶片
arrangement|整理， 排列， 安排； 准备工作
revenue|收入， 收益； 税收， 岁入
strip|脱光衣服；剥夺，夺去 n. 条带
solution|解决； 解决办法； 溶液
continuous|连续不断的； 延伸的
opponent|对手， 敌手， 对抗者
accelerate|使加快， 使增速
backward|[-]倒； 向后， 往回 adj. 向后的，倒的；落后的，进步慢的
grain|谷物， 谷粒； 颗粒； 少量， 微量
maid|女仆， 侍女
residence|住处， 住宅； 居住； 居住资格
credit|信贷，赊欠；赞扬，荣誉；学分；信任 vt. 相信； 把…记入贷方； 把…归于
regardless|不顾后果地； 不管怎样， 无论如何
oxygen|氧， 氧气
intensive|加强的； 精深的， 透彻的； 精耕细作的
alter|改变， 变更， 变动
combine|结合， 联合； 化合 n. 联合企业； 联合收割机
ideal|理想的；观念的；空想的 n. 理想； 理想的东西
bearing|举止， 风度； 方位， 方向感； 影响
illustrate|说明
occur|发生， 出现， 存在； 被想起， 被想到
comedy|喜剧， 喜剧性
broom|扫帚
establishment|建立， 设立， 确立； 企业； 当权人物
pressure|压，压强；压迫 vt. 对…施加压力， 迫使
breeze|飘然而行 n. 微风，和风
trash|垃圾，废物；拙劣的文学作品；没用的人，社会渣滓，败类 vt. 捣毁， 破坏
painter|漆工； 画家
millimetre|毫米
horn|角； 号角； 警报器
specialist|专家
infer|推论， 推断； 猜想
compass|罗盘， 指南针； 圆规； 界限， 范围
background|出身背景， 经历； 背景资料； 背景， 底子
sore|痛的；恼火的；急剧的，剧烈的 n. 疮， 痛处
dispose|处理， 解决； 使倾向于
glow|发白热光 n. 白热光；脸红；激情
curtain|门帘， 窗帘； 幕
laughter|笑， 笑声
constitution|宪法， 章程； 组成； 设立
blend|n&v. 混合
certificate|证书， 证件， 执照
mess|凌乱状态，混乱的局面；困境 vt. 弄糟， 弄脏， 搞乱
sour|酸的；馊的，酸味的；脾气坏的 v. 变酸， 变馊； 变得乖戾
delete|删除， 擦掉
nonsense|胡说， 废话； 冒失的行动
stain|玷污；给…着色 n. 污点， 污迹
transform|使改观， 改革； 变换， 把…转换成
leadership|领导
genuine|真的， 真正的； 真诚的
x-ray|X射线， X光
physical|身体的； 物理的； 物质的， 有形的
fulfil|履行， 实现， 完成； 满足， 使满意
wicked|坏的， 令人厌恶的； 淘气的， 顽皮的
spokesman|发言人
equation|方程， 等式
impressive|给人深刻印象的
compound|复合的， 化合的 n. 化合物，复合物；复合词 vt. 使恶化， 加重； 使化合， 使合成
structure|结构，构造 vt. 建造
intensity|强烈， 剧烈； 强度
waken|醒来， 弄醒
stake|桩；利害关系；股份；赌金，赌注 vt. 以…打赌， 拿…冒险
extraordinary|非同寻常的， 特别的
witness|证据；目击者，证人 vt. 目击； 为…作证， 证明
concerning|关于
attraction|吸引， 吸引力； 引力； 具有吸引力的事物
conventional|普通的； 习惯的， 常规的； 因循守旧的
regulation|规章， 规则； 管理， 控制； 调节
puzzle|迷惑，为难；苦思 n. 智力测验； 谜， 难题， 令人费解的事； 困惑， 迷惑
circulation|循环； 流传； 发行， 流通
bake|烤， 烘， 焙
mere|仅仅的； 纯粹的
accommodation|住处； 膳宿
evident|明显的， 明白的
suburb|郊区， 郊外， 近郊
lodge|暂住，借宿 n. 乡间小屋； 旅舍
threat|威胁， 恐吓； 凶兆， 征兆
writer|作者， 作家
simplify|简化， 使简明
breast|乳房； 胸脯， 胸膛
invention|发明， 创造； 捏造
mercy|仁慈， 宽容； 恩惠； 幸运
annoy|使恼怒； 打搅
curl|鬈发； 卷曲， 卷曲物
inform|告发， 告密 vt. 通知；报告
psychological|心理的
glue|胶，胶水 vt. 胶合
commit|犯， 干； 使承诺； 把…托付给； 调拨…供使用， 拨出
scream|尖叫，呼啸 n. 尖叫声
sorrow|悲痛， 悲哀， 悲伤； 伤心事， 不幸的事
crash|发出撞击声；垮台，破产；冲，闯 vt. 碰撞；坠落 n. 碰撞； 破裂声
patch|补丁；斑，与周围不同的部分；一小块地 vt. 补， 修补
observer|观察员， 观察者
character|性格， 特性； 性质； 人物， 角色； 符号； 字
reflect|反映， 显示； 反射， 映现； 深思， 考虑， 反省
procession|队伍， 行列
contribution|贡献， 促成作用； 捐款， 捐献物； 稿件
marxist|马克思主义的 n. 马克思主义者
bang|猛击， 猛撞； 发出砰的一声， 砰砰地响 n. 巨响，枪声；猛击 vt. 猛击，猛撞；砰地敲
brow|额， 眉， 眉毛
meaning|意义， 意思； 目的； 重要性
ignorant|不知道的， 无知的
magnetic|磁的； 有吸引力的
band|乐队；群，伙；带；条纹；波段 vt. 用带绑扎
orbit|轨道 vt. 做轨道运行
comprise|包含， 包括， 构成
moderate|中等的； 温和的， 稳健的； 有节制的 v. 和缓， 减轻； 节制
resident|居住的， 定居的； 住校的， 住院的 n. 居民，定居者；住院医生
spray|喷， 溅散 n. 浪花，水花；喷雾
distinguish|区别， 辨别， 识别； 使显出特色， 使杰出
receiver|听筒； 接收器
outer|外面的， 外层的
invent|发明， 创造； 捏造
fluent|流利的， 流畅的
shortcoming|短处， 缺点
substantial|可观的， 大量的； 结实的， 坚固的； 实质的， 真实的
execute|将…处死； 实施， 执行
benefit|有益于； 得益 n. 利益，恩惠；救济金，保险金，津贴
flood|淹没； 涌入 n. 洪水；大量
vitamin|维生素
intention|意图， 意向， 目的
rude|粗鲁的， 不礼貌的； 粗糙的， 粗陋的
symptom|症状； 征候， 征兆
pillar|柱， 柱子； 栋梁
thereby|因此， 从而， 由此
unique|唯一的， 独一无二的； 极不寻常的， 极好的
funeral|葬礼， 丧礼， 丧葬
boost|提高，使增长；推动，激励；替…做广告，宣扬 n. 提高， 增长； 推动， 激励
fireman|消防队员； 司炉工
sincere|真诚的， 诚挚的
male|男的，雄的 n. 男子， 雄性动物
ministry|部
religious|宗教的； 笃信宗教的， 虔诚的
nevertheless|仍然， 然而
prominent|突出的， 杰出的； 突起的， 凸出的
shelter|掩蔽处，躲避处；住所；掩蔽，保护 vt. 掩蔽， 庇护； 躲避
outset|开始， 开端
jewel|宝石； 宝石饰物
scan|细看，审视；扫描，浏览 n. 扫描
association|协会， 团体； 联合， 交往
fundamental|基础的，基本的 n. 基本原则
eliminate|消灭， 消除， 排除； 淘汰
global|全球的， 全世界的； 总的， 完整的
entitle|给…权利； 给题名
outline|提纲，要点；外形，略图 vt. 概述； 描…外形
fade|褪色；逐渐消失；凋谢 vt. 使褪色
unless|除非， 如果不
butterfly|蝴蝶
excess|过量的， 额外的 n. 超越； 过量， 过度
glance|看一下 n. 一瞥 vt. 用扫视； 反射
perspective|视角， 观点； 远景， 景观； 透视画法， 透视图
relationship|关系， 关联
equality|等同， 平等， 相等
destruction|破坏， 毁灭， 消灭
dictation|口授； 听写
stiff|极其， 非常； 僵硬地 adj. 硬的，僵直的；不灵活的；拘谨的，生硬的；费劲的；强烈的
expression|词语； 表达； 表情
invade|入侵， 侵略， 侵袭
reaction|反应； 反作用
childhood|童年， 幼年， 早期
wolf|狼
accordance|一致； 和谐
thorough|彻底的， 详尽的
appeal|呼吁，恳求；申诉，上诉 vt. 上诉 n. 感染力， 吸引力； 呼吁， 上诉
democracy|民主， 民主制； 民主国家
transportation|运输， 运送， 客运
dye|染 n. 染料； 染色
evolve|使进化， 使发展
extensive|广阔的， 广泛的
congratulation|贺词； 祝贺， 恭喜
abandon|离弃，丢弃；遗弃，抛弃；放弃 n. 放任； 纵情
definitely|一定地， 明确地
inspire|吸气； 赋予灵感 vt. 鼓舞，给…以灵感
marvelous|奇迹般的， 了不起的
household|家庭的； 家喻户晓的 n. 家庭，户；家务
geometry|几何， 几何学
ratio|比， 比率
devote|将…奉献给； 把…专用
agent|代理人， 代理商； 政府代表； 动因， 原因； 剂
wool|羊毛； 毛线， 绒线
wholly|完全地， 全部地
instinct|本能， 天性； 直觉
approximate|近似的 vt. 近似； 估计
invest|投资， 投入； 授予
afterward|后来， 以后
reputation|名誉， 名气， 名声
project|伸出； 投射； 预计 n. 方案， 计划； 课题， 项目； 工程
shrug|n&v. 耸肩
independence|独立， 自主， 自立
coordination|同等； 调和
presentation|提供， 显示； 外观， 图像； 授予， 赠送； 报告， 介绍； 表演
diameter|直径
barn|谷仓； 牲口棚
bark|吠，叫 n. 吠声， 叫声； 树皮
loop|成环， 成圈 n. 圈，环，回路；循环
restrain|阻止， 控制； 抑制， 遏制
greedy|贪吃的； 贪婪的； 渴望的
awkward|笨拙的， 尴尬的； 难操纵的， 使用不便的； 不灵巧的
bare|赤裸的；光秃的，无遮盖的；刚刚够的，勉强的 vt. 露出， 显露
ruin|毁坏 n. 毁灭；废墟
crane|起重机， 摄影升降机； 鹤
beard|胡须， 络腮胡子
impatient|不耐烦的， 急躁的
spill|溢出，洒落 n. 溢出
owing|应付的， 未付的
collection|搜集， 聚集， 积聚； 收集， 收取； 收藏品， 收集的东西
gardener|园丁， 花匠
conquest|攻取， 征服， 克服
finding|发现； 调查的结果； 裁决
dense|密集的， 浓厚的； 密度大的
fortnight|两星期， 十四天
laboratory|实验室， 研究室
inspect|进行检查； 进行视察 vt. 检查，审查；检阅
campaign|参加运动； 参加竞选 n. 战役；运动
systematical|有系统的， 有计划的
vital|致命的， 生死攸关的； 极其重要的； 生命的， 有生命力的
conflict|冲突， 抵触 n. 冲突， 抵触， 争论； 战斗， 战争
farewell|告别， 欢送会
allow|允许， 准许； 同意给； 承认； 允许…进入
appliance|用具， 器具， 器械； 家电
mass|大量的，大规模的 v. 聚集， 集中 n. 众多，大量；团，块，堆；群众；质量
lord|领主， 君主， 贵族
detect|察觉， 发觉； 侦查出
amateur|业余爱好的， 业余的； 外行的 n. 业余爱好者；外行
poisonous|有毒的； 恶毒的
condemn|谴责， 指责； 判…刑， 宣告…有罪
beast|兽， 野兽， 牲畜； 凶残的人， 令人厌憎的人
assistance|协助， 援助
commerce|商业， 贸易； 社交
gesture|做手势 n. 姿势，手势，姿态
admit|承认， 供认； 准许…进入
poem|诗
interest|兴趣；利益，利害关系；利息 vt. 使感兴趣
gulf|海湾； 巨大的分歧
poet|诗人
definition|定义， 释义， 定界； 清晰， 鲜明
shave|剃，刮，刨，削；修面，刮脸 n. 修面， 刮脸
organic|有机体的， 有机物的
mask|面具，面罩，口罩；伪装 vt. 遮盖， 掩饰
summary|概括的， 概要的； 实时的， 即决的 n. 摘要，概要，一览
apply|适用； 申请， 请求； 涂， 敷， 施 vt. 应用，实施；使用；涂敷；把…施于
inferior|下等的，劣等的；次于…的 n. 下级， 下属
steamer|轮船， 汽船
recently|最近， 新近
overlook|忽视； 宽恕； 俯瞰
politician|政治家， 政客
incredible|不能相信的， 不可信的； 难以置信的， 不可思议的； 惊人的
dramatic|引人注目的， 激动人心的； 突然的
mosquito|蚊子
guitar|吉他， 六弦琴
layout|布局， 安排， 设计
artificial|人工的， 人为的； 矫揉造作的； 模拟的
imaginary|想象中的， 假想的
removal|除去， 消除； 移动， 搬迁
formula|公式， 方程式； 原则， 方案； 配方
comment|评论 n. 评论，意见，注释；闲话，议论
revolt|反叛，起义；反抗，违抗；厌恶，生反感 n. 反叛， 起义
disgust|n&vt. 厌恶， 憎恶
stem|起源 n. 茎，干；词干 vt. 堵住， 止住， 停住
sunshine|日光， 阳光
trend|伸向；倾向 n. 倾向
achievement|完成； 成就， 成绩
mechanic|技工， 机修工； 力学， 机械学； 过程， 方法， 技术性细节
desirable|值得向往的， 令人满意的
balcony|阳台； 楼厅， 楼座
consist|由…组成； 在于； 一致
preparation|准备， 预备； 制剂
reliable|可靠的， 可信赖的
relate|有关， 涉及； 符合； 相处 vt. 使有关联；讲述，叙述
critic|批评家， 爱挑剔的人
elevator|电梯， 升降机
grammar|语法； 语法书
enable|使能够， 使可能
preliminary|预备的，初步的 n. 初步做法， 起始行为
dependent|依靠的， 依赖的； 取决于…的
obstacle|障碍， 障碍物， 妨碍
profession|职业； 声明， 表白
calculator|计算器， 计算者
van|大篷车， 运货车
biology|生物学， 生态学
worm|虫， 蠕虫
compress|压紧， 压缩
arise|出现； 由…引起； 起身， 起床
collaborative|合作的， 协作的， 协力完成的
cherish|珍爱； 怀有
constitute|组成， 形成； 设立； 任命
cattle|牛； 牲口， 家畜
imagination|想象， 想象力， 空想； 想象出
resistance|反抗， 抵制； 抵抗力， 抵抗性； 阻力； 电阻
underneath|在下面，在底下 prep. 在…下面，在…底下 n. 下部， 底部
nursery|托儿所， 保育室； 苗圃
mate|成为配偶， 交配 n. 伙伴，同事；配偶，配对物；大副
convince|使确信， 使信服， 说服
emperor|皇帝
prolong|拉长， 延长
theory|理论， 原理； 学说； 意见， 看法
distress|忧虑， 痛苦， 悲伤； 不幸
flock|羊群， 群； 大量
internal|内的； 国内的； 内心的
extension|延长部分， 伸展； 电话分机， 分机号码
signature|署名， 签字， 签名
steep|险峻的， 陡峭的； 过高的； 急剧的
thumb|示意要求搭车 n. 拇指
republican|共和政体的；共和党的 n. 共和党人
literary|文学的； 文人的， 书卷气的
architect|建筑师， 设计师； 缔造者
forehead|额头； 前部
classical|古典的， 经典的
privilege|特权； 优惠
foundation|基础；
substitute|代替人；代用品 vt. 用…代替
punch|猛击；穿孔 n. 猛击； 冲床； 穿孔机； 力量， 效力
naturally|当然； 天然地； 天生地
flexibility|灵活性， 机动性， 柔韧性
mysterious|神秘的， 诡秘的
moreover|而且， 再者， 此外
identity|身份； 个性， 特性； 同一性， 一致性
scatter|撒， 散播； 散开， 驱散
installation|安装； 装置， 设施； 就任， 就职
writing|书写， 写； 著作
federal|联邦的， 联盟的
violate|违反， 违背； 亵渎； 侵犯； 妨碍
verify|证实， 查证， 证明
collective|集体的，集合性的 n. 团体， 集体
excursion|远足， 短途旅行
steer|掌舵， 驾驶； 操纵
event|事件， 大事， 事变
academy|研究会， 学会； 专门学校
undergo|经历， 经受， 忍受； 接受
reward|报答，奖赏；报酬，酬金 vt. 报答， 酬谢， 奖励
include|包括， 包含
sympathize|同情， 怜悯； 体谅； 赞同
alongside|在旁边，沿着边，并排地 prep. 在…旁边， 沿着…的边； 和…在一起
swallow|燕子；吞，咽 vt. 吞， 咽； 轻信， 轻易接受； 承受， 使不流露； 咽下口水
agency|经办， 代理； 代理处； 专门行政部门
coupon|礼券， 优惠券， 配给券； 联票； 票证
railroad|铁路 vt. 由铁路运输
nucleus|核心； 核
fascinating|迷人的， 有极大吸引力的
abstract|抽象的，抽象派的 n. 摘要， 梗概； 抽象派艺术作品 vt. 做…的摘要； 提取
sting|刺，蜇，叮 n. 刺伤处，蜇伤处
haste|急速， 急忙； 草率
agenda|议事日程
appearance|出现， 来到； 外观
liquid|液体的； 清澈的； 流畅的 n. 液体
culture|文化， 文明； 教养； 培养； 培养菌
sleeve|袖子， 袖套
devotion|献身， 奉献； 忠实； 热爱； 虔诚
anonymous|匿名的； 无名的； 无特色的
stir|搅动；拨动；激动；唤起 n. 搅拌， 搅动； 激动， 骚乱
fisherman|渔民， 渔夫
span|跨距，一段时间 vt. 持续， 贯穿； 包括； 横跨， 跨越
insult|侮辱， 凌辱 n. 侮辱， 凌辱
existence|存在， 实在， 生存
craft|工艺， 手艺； 船， 航空器
butcher|肉商，肉贩，屠夫 vt. 屠宰， 残杀
poll|民意测验；政治选举，大选 vt. 对…进行民意测验； 获得
minority|少数； 少数民族
pole|杆； 极， 磁极， 电极
float|浮动， 漂浮； 飘动
graceful|优美的， 优雅的； 得体的
fourfold|四倍， 四重 adj. 四倍的，四重的
preferable|更可取的， 更好的， 更合意的
reference|提到， 论及； 参考； 引文； 参考书目； 证明书， 证明人
frog|蛙
spite|恶意，怨恨 vt. 刁难， 欺侮
chamber|会议室， 会所； 房间； 腔， 室
arrange|安排， 准备， 整理
coarse|粗的， 粗糙的； 粗劣的； 粗俗的
nephew|侄子， 外甥
publicity|公众的注意， 名声； 宣传， 宣扬
depart|离开， 起程， 出发
exaggerate|夸大， 夸张
imply|暗示， 意指
capture|捕获， 俘获； 夺得
commitment|承诺， 许诺， 保证； 信奉， 献身； 承担的义务
spade|铲， 铁锹
manufacture|制造，加工 n. 制造， 制造业
sequence|连续， 接续， 一连串； 次序， 顺序
collision|碰撞； 冲突， 抵触
qualification|资格， 资格证明， 合格证书； 限制， 限定
provision|供应； 准备； 条款， 规定； 给养， 口粮
recruit|招募，吸收 n. 新兵； 新成员
thrust|插；戳，刺 n. 戳， 刺； 要点， 要旨； 推力
fame|名声， 名望
replacement|代替， 取代； 更换， 调换； 替代的人
mud|泥， 泥浆
mug|大杯 vt. 对…行凶抢劫
pond|池塘
arrival|到达， 到来； 到达者， 到达物
scientific|科学的
frequent|时常发生的，常见的 v. 常到， 常去
according|相等的， 一致的， 依…而定的
insure|为…投保； 确保
powder|粉， 粉末
membership|会员身份， 会籍； 全体会员， 会员数
error|错误， 谬误， 差错
platform|平台， 站台， 讲台； 纲领， 宣言
network|网状物； 广播网， 电视网； 网络
jealous|妒忌的， 猜疑的； 精心守护的
rust|生锈， 氧化 n. 铁锈
trace|痕迹；丝毫，少许 vt. 跟踪； 追溯； 描摹
negro|黑人
modernization|现代化
grave|严重的； 严肃的 n. 坟墓
criminology|犯罪学， 刑事学
advantage|优点， 优势， 好处
assistant|助理的， 辅助的 n. 助手，助理，助教
inn|小旅店， 小酒店
instead|作为替代； 却， 反而
controversy|争论， 辩论
command|命令， 指挥， 控制
newsstand|报摊， 杂志摊
worthless|无价值的， 无用的
performance|演出； 执行， 完成； 工作情况， 表现； 工作性能
dessert|甜食， 点心
ambassador|大使， 使节， 派驻国际组织的代表
anticipate|预料， 预期， 期望； 先于…行动； 提前使用
variable|易变的 n. 变量
temple|圣堂， 神殿， 庙宇
growth|增长， 增长量； 生长， 生长物
landscape|风景，景色；风景画；全景 vt. 美化…的景观
weave|织， 编
carrot|胡萝卜
normally|通常； 正常地
exception|例外， 除外
vague|模糊的， 含糊的
temporary|暂时的， 临时的
fare|进展 n. 车费，船费，票价
desperate|拼死的， 不顾一切的； 绝望的； 极需要的
leading|指导的， 带头的； 最主要的； 饰演主角的
awful|令人不愉快的， 难过的； 非常的， 极大的
accuracy|准确， 精确
handy|手边的， 便于使用的
urge|鼓励；推进，催促；竭力主张，强烈要求 n. 冲动， 强烈的欲望
resolution|正式决定， 决议； 决心， 决意； 解决， 解答； 分辨率， 清晰度
via|经过， 通过
setting|环境， 背景， 布景； 调节， 设定的位置
score|得， 给…打分； 画线于， 做记号于； 赢得 n. 得分，比数，成绩；二十
quote|引用，援引 n. 引文， 引语； 报价， 牌价； 引号
graduate|研究生的 v. 毕业 n. 毕业生；研究生
famine|饥荒； 严重的缺乏
gramme|gram的英式拼法
absent|缺席的， 不在场的； 缺乏的， 不存在的； 心不在焉的
rag|破布， 碎布； 破旧衣服
visual|看得见的 n. 视觉资料
understanding|体谅的， 宽容的， 通情达理的 n. 理解，理解力；谅解；协议；相互理解，融洽
empire|帝国
educate|教育， 培养， 训练
fairy|小精灵， 小仙子
ashamed|惭愧的， 羞耻的， 害臊的
instruct|指示， 命令； 通知； 教授， 训练
rat|鼠
mayor|市长
virtually|实际上， 事实上
fairly|相当， 尚可， 还； 公平地
handwriting|笔迹， 手迹； 书法
merchant|商人
raw|自然状态的， 未加工过的； 生的； 未经分析的， 原始的； 生疏无知的， 未经训练的； 露肉而刺痛的
proportional|比例的， 成比例的
economy|经济； 节约， 节省
community|社区， 社会， 公社； 团体， 界； 群落
packet|小包， 小盒
version|译本； 说法； 改写本
airport|机场， 航空港
courtyard|庭院， 院子
nationality|国籍； 民族
selection|选择， 挑选； 被挑选出来的人， 精选品； 可供选择的东西
institute|研究所，学院 vt. 建立， 设立
aboard|adv&prep. 在船上， 上船
endure|忍受， 容忍； 持久， 持续
detail|细节，枝节；零件 vt. 详细说明
shortly|立刻， 不久； 不耐烦地； 简短地
hobby|业余爱好， 癖好
appropriate|适当的， 恰当的
providing|倘若
fate|命运， 天数
throat|咽喉， 喉咙； 嗓音
utility|效用， 有用， 实用； 公用事业
immediately|立即， 马上； 直接地， 紧接地
manual|用手的；手工做的 n. 手册， 指南
measurement|衡量， 测量； 尺寸， 大小
optimistic|乐观的， 乐观主义的
vocabulary|词汇表， 词汇， 语汇
retire|退休， 退役； 退下， 退出， 撤退； 就寝
aspect|方面； 朝向， 方向； 样子， 外表
particle|粒子， 微粒； 小品词， 语助词
aggressive|侵略的， 好斗的； 敢做敢为的； 有进取心的
behavior|行为， 举止， 表现
musician|音乐家， 乐师
minimize|将…减少； 最小化
descend|下来， 下降； 下倾
saint|圣徒； 圣人， 道德高尚的人； [用于人名或地名等前]圣
density|密集， 稠密； 密度
logical|逻辑的， 合乎常理的
oblige|迫使； 施恩于， 帮…的忙； 使感激
slam|砰地关上；猛力拉，砰地放下；猛烈抨击 n. 砰的一声
characterize|成为…的特征， 以…为特征； 描绘的特性， 描述
swing|摇摆，回转；突然转向 n. 摇摆； 秋千
ridiculous|荒谬的， 可笑的
handbag|手提包
invasion|入侵， 侵略， 侵犯
spin|旋转；晕眩；纺，织；绞干，甩干 n. 旋转， 自转
severe|严重的； 严厉的， 严格的； 严峻的， 艰难的； 朴素的， 不加装饰的
emerge|出现， 涌现， 冒出
shallow|浅的；浅薄的 n. 浅滩， 浅水处
lease|租约，租契 vt. 出租； 租得， 租有
exploit|剥削； 利用； 开拓 n. 业绩， 功绩
slap|掴，掌击，拍；啪的一声放 n. 掴， 掌击， 拍
spit|吐唾沫，吐出 n. 唾沫， 唾液
scout|侦察， 寻找 n. 侦察员，侦察机，侦察舰；童子军
anniversary|周年纪念日
register|登记， 注册； 指示， 自动记下； 流露； 表示， 表达； 把挂号 n. 登记；登记表
restless|焦躁不安的； 静不下来的， 运动不止的
persuasive|劝诱的； 有说服力的
fleet|舰队， 船队
communicate|通讯； 交际， 交流； 连接， 相通； 传达， 传播； 传染
evidence|根据， 证据； 证人
saddle|鞍，鞍状物；车座 vt. 给…装鞍； 使承担任务
rural|农村的， 乡村的
official|官员的；官方的，正式的 n. 官员， 行政人员， 高级人员
historical|历史的， 有关历史的
repetition|重复， 反复
fortunately|幸运地； 幸亏
acid|酸的， 酸性的 n. 酸
transmission|传播， 发射； 传送， 传递； 传染
shortage|不足， 缺少
discrimination|区别， 辨别； 识别力； 差别对待， 歧视
female|雌的； 女的 n. 雌性动物；女子
microphone|扩音器， 话筒， 麦克风
swift|快的； 反应快的； 敏捷的
surrender|n&v. 交出， 放弃； 投降
faint|不清楚的，模糊的 v. 晕倒，昏厥 n. 昏厥
world-wide|遍及全球的
minister|部长， 大臣； 公使， 外交使节； 牧师
pose|摆姿势；假装，装腔作势 vt. 使摆好姿势；造成，引起；提出，陈述 n. 样子， 姿势
remedy|补救办法，纠正办法；药品；治疗法 vt. 补救， 纠正； 医治， 治疗
jail|监狱，看守所 vt. 监禁， 拘留； 塞满； 卡住； 干扰
consent|同意 n. 同意，赞成
insist|坚持， 坚决认为； 坚持要求
typewriter|打字机
helpless|无助的； 无能的； 无法抗拒的
respect|尊敬；尊重；问候；方面 vt. 尊敬； 尊重
volume|卷， 册， 书卷； 容积， 体积； 音量， 响度
retreat|n&vi. 退却， 撤退； 退避， 退缩
ache|疼痛；渴望 n. 疼痛
mutual|相互的； 共同的
shell|壳，贝壳；外壳，框架；炮弹 vt. 剥…的壳； 炮击
guideline|指导方针， 准则
loose|松的； 不精确的， 不严密的； 散漫的
therefore|因此， 所以
exchange|n&v. 交换； 交流； 兑换
hesitate|犹豫， 踌躇； 含糊； 不情愿
rifle|来复枪， 步枪
private|私人的；秘密的；私下的；私营的 n. 士兵， 列兵
baggage|行李
companion|同伴， 共事者； 伴侣
breakdown|垮， 衰竭； 损坏， 故障； 倒塌
paste|糊，糨糊 vt. 粘， 贴
overtake|追上， 超过； 突然降临于， 意外地碰上
jeans|工装裤， 牛仔裤
overnight|整夜， 通宵； 一夜间， 突然 adj. 一整夜的； 一夜间的， 突然的
behave|表现， 举止； 运转， 作出反应
stretch|伸展，延续；伸长，拉长；倾注全力；紧张 n. 一段时间， 一段路程， 连绵的一片； 伸展， 延伸
undo|解开， 打开； 取消， 撤销
accomplish|达到； 完成
laser|激光
mixture|混合， 混合物
engine|引擎， 发动机； 机车
responsible|需负责任的， 承担责任的； 有责任感的， 负责可靠的； 责任重大的， 重要的
scope|范围； 余地， 机会
democratic|民主的， 民主政体的
medal|奖牌， 奖章， 勋章
satellite|卫星， 人造卫星
bullet|枪弹， 子弹， 弹丸
recorder|录音机， 录像机； 记录装置， 记录仪
identify|一致 vt. 认出，鉴定；把…等同于
embrace|拥抱，怀抱 vt. 拥抱； 包括； 包围
nitrogen|氮
pour|灌， 倒； 倾泻
label|标签；标记，符号 vt. 贴标签于； 把…称为
improvement|改进， 改善； 改进处
slippery|滑的； 狡猾的
scissors|剪刀
significance|意义， 含义； 重要性， 重大
modify|更改， 修改； 修饰
horizon|地平线； 眼界， 见识
environment|环境， 外界； 围绕
airplane|飞机
pledge|保证，誓言 vt. 保证， 许诺
progressive|前进的； 渐进的； 进行式的
reservoir|水库， 蓄水池； 储藏， 汇集
deliberate|故意的， 蓄意的； 慎重的， 深思熟虑的 v. 仔细考虑， 思考
swear|宣誓； 咒骂
atmosphere|大气， 空气； 气氛， 环境
decorate|装饰， 装潢， 修饰
copyright|版权
biotechnology|生物工艺学
career|生涯， 职业， 经历
occupation|占领， 占据； 职业； 从事的活动， 消遣
tendency|趋向， 趋势， 倾向
release|释放， 排放； 解除， 解脱； 放开， 松开； 发布； 发行
charter|包租的， 租用的 n. 宪章，共同纲领；特许状，许可证；包租 vt. 包，租
slim|苗条的；薄的；少的 v. 减轻体重， 变苗条
arithmetic|算术， 四则运算
rib|肋骨
faulty|有错误的， 有缺点的
liberate|解放， 释放
rid|使摆脱， 解除…的负担， 从…中清除
variation|变化， 变动； 变异； 变奏
moral|道德的，有道德的 n. 品行； 道德规范； 寓意
defect|变节， 叛变 n. 缺点， 缺陷， 欠缺
reinforce|增强， 加强， 增援
explode|爆炸； 激增； 发怒 vt. 使爆炸
casual|偶然的； 非正式的； 临时的， 不定期的； 漠不关心的， 冷淡的
decline|下降， 减少； 衰退， 衰落； 谢绝， 拒绝 n. 下降，减少；衰退
property|财产， 所有物； 房产； 物业； 性质， 性能
succeeding|以后的， 随后的
brave|勇敢的； 华丽的
similar|相似的， 类似的
viewpoint|观点， 看法， 见解
anyhow|无论如何， 不管怎么说； 随随便便地， 杂乱无章地
specify|指定； 详细说明
whistle|吹口哨， 鸣笛声； 呼啸而过 n. 口哨；呼啸而过
handle|柄，把手 vt. 拿， 触； 操作， 处理
forth|向前； 向外， 往外
tough|困难的， 难对付的； 坚强的， 能吃苦耐劳的； 健壮的； 坚硬的， 严格的； 老的， 硬的； 粗暴的， 充满暴力的
crossing|人行横道， 交叉口； 横渡
script|剧本， 广播稿； 书写用的字母； 笔迹， 手迹
submerge|淹没， 潜入水中
system|系统； 制度， 体制； 方法， 做法； 身体
compose|组成， 构成； 创作， 为…谱曲； 使平静， 使镇静
spot|点，斑点；地点，处所；少量 vt. 认出， 发现； 玷污
roller|滚筒， 滚轴
partial|部分的； 不公平的； 偏爱的， 偏袒的
aid|帮助； 救护； 助手； 辅助手段
tone|腔调， 语气； 音调； 风格， 气度； 色调， 明暗
confident|确信的， 肯定的； 自信的
retain|保留， 保持
swell|膨胀，隆起；增长，增强，增多，扩大 n. 波浪起伏； 鼓起， 隆起； 增强
skilled|有技能的； 熟练的； 需要技能的
local|地方性的； 本地的； 局部的； 狭隘的
remind|提醒， 使想起
crude|简陋的， 天然的； 粗鲁的， 粗俗的
manufacturer|制造商； 制造厂
crew|全体船员； 一队工作人员
valid|有效的； 正当的； 有根据的， 有理的
withstand|抵挡， 反抗
defeat|n&vt. 战胜， 挫败
vacuum|用吸尘器清扫 n. 真空；真空吸尘器
encourage|鼓励， 怂恿； 促进， 助长， 激发
bubble|冒泡； 沸腾 n. 泡
era|时代， 年代， 纪元
yield|出产；让出，放弃；屈服，顺从；倒塌，垮掉 n. 产量
electronic|电子的 n. 电子学； 电子设备
vacation|假期， 休假
outcome|结果
elegant|优美的， 文雅的， 讲究的； 简练的， 简洁的
tender|嫩的；脆弱的；疼痛的，一触即痛的；温柔的 vt. 提出 n. 投标
curriculum|课程， 全部课程
meantime|其间， 同时
powerful|强大的， 有力的， 有权的； 强壮的， 强健的
slip|滑跤，滑落，溜；下降，跌落；悄悄放进 n. 疏漏， 差错
species|种， 类
anchor|抛锚， 停泊； 把…系住， 使固定； 担任主持人； 固定， 扎根 n. 锚；给人安全感的物
preceding|在前的， 在先的， 前面的
cite|引用， 引证； 传唤， 传讯； 表彰， 嘉奖
logic|逻辑， 推理， 逻辑学
acquaintance|认识， 了解； 熟人
royal|王室的， 皇家的
internship|实习生身份； 实习医师期
shed|脱落，脱去；流出，流下；发出，散发 n. 棚， 小屋， 货棚
eyesight|视力， 目力
precision|精确， 精密
glove|手套
screen|屏幕，银幕；屏风；帘，纱窗 vt. 掩蔽， 遮蔽； 放映， 播放； 审查， 甄别
naked|裸体的； 无遮蔽的
trial|试， 试验； 审判； 讨厌的人
correspond|相符合， 相当； 通信
spur|刺激物 vt. 刺激， 鞭策， 激励
perception|感知， 觉察； 认识， 观念， 看法
rear|后部的，背后的 n. 后部，背面；后方 vt. 抚养， 饲养； 种植
amongst|在…之中
undertake|从事； 承担； 同意； 保证
insect|昆虫， 虫
bureau|局， 司， 处， 社， 所
moist|湿润的， 潮湿的
cable|缆， 索， 电缆； 电报
qualify|胜任， 具有资格， 合格； 限定
intense|强烈的； 紧张的； 认真的； 热情的
pregnant|怀孕的， 妊娠的
border|边，边缘，边界 vt. 给…加上边， 围； 邻接； 与…接壤
estate|土地， 住宅区， 地产； 财产， 遗产； 庄园， 种植园
applicable|能应用的； 合适的， 适当的
admission|允许进入； 承认； 入场费， 入场券
brass|黄铜， 黄铜器， 铜管乐器
expense|花费， 消费； 费用， 开支； 业务费用
rumour|谣传， 谣言
contemporary|当代的；同时代的 n. 同代人， 当代人
gear|齿轮，传动装置，排挡；用具，设备；衣服 vt. 使适应， 使适合
boundary|分界线， 边界
rob|抢劫， 盗窃
elderly|较老的，年长的 n. 到了晚年的人， 老年人
financial|财政的， 金融的
rod|杆， 棒
dumb|哑的； 无言的； 说不出话的
respective|各自的， 各个的， 分别的
media|新闻媒介， 传播媒介
favour|好感；赞同；恩惠 vt. 赞同； 喜爱， 偏爱； 有利于
pollute|弄脏， 污染； 腐蚀
harden|变硬； 变得坚强
eve|前夜， 前夕， 前一刻
pronoun|代词
define|给…下定义， 限定
dictate|口授； 命令， 规定， 要求 n. 命令， 指挥
construction|建造； 建筑物； 结构
predict|预言， 预告， 预测
dump|倾卸，倾倒；倾销 n. 垃圾场
render|使得， 致使； 给予， 提供； 翻译
universal|普遍的； 通用的； 全世界的
chemist|化学家， 药剂师
frontier|边境， 边疆； 新领域
abroad|到国外； 在传播， 在流传
radical|根本的，基本的；激进的，激进派的 n. 激进分子
relieve|使轻松， 使宽慰， 缓解； 使得到调剂； 接替
drawer|抽屉
requirement|要求； 必要条件； 需要， 需要的东西
transport|运输 n. 运输， 运输工具
employment|工作； 雇用； 使用
specific|特有的；具体的，明确的 n. 详情， 细节
application|申请， 申请书； 施用， 涂抹； 应用， 实施； 实用性
engage|使从事； 聘用； 吸引； 占用； 使订婚
acre|英亩
whisper|低声地讲 n. 低语， 耳语
appetite|食欲， 胃口； 欲望
semester|学期
strategy|战略， 策略
dull|乏味的， 单调的； 晦暗的， 阴沉的； 低沉的； 笨的； 钝的
collapse|倒坍；塌下 n. 突然失败；突然瓦解
clumsy|笨拙的， 愚笨的； 粗陋的； 不得体的
territory|领土， 版图； 领域
concession|让步， 妥协； 特许， 特许权； 承认， 认可
accurate|准确的， 正确无误的
maintain|维持； 维修， 保养； 主张； 赡养
shift|移动，转移；改变，转变 n. 转换， 转变； 轮班
echo|重复， 模仿； 发出回声 n. 回声；反响，共鸣
erect|竖直的， 垂直的 vt. 建造；使竖立
bargain|讨价还价 n. 特价商品；协议，交易
professional|职业的，专业的，专门的 n. 自由职业者， 专业人员
elective|选举的，有选举权的；可任意选择的 n. 选修课程
accusation|谴责； 【律】 指控
protein|蛋白质
annual|每年的，一年一次的 n. 年报， 年鉴； 一年生的植物
exclusive|奢华的，高级的；独有的，独享的；排斥的，排他的；不包括…的，不把…计算在内的 n. 独家新闻
jar|感到不快； 震动， 摇动 n. 罐子，坛子，广口瓶
poverty|贫穷， 贫困
resort|求助，凭借，诉诸 n. 求助， 凭借， 诉诸； 求助的对象， 采用的手段； 常去之地， 胜地
goodness|天哪 n. 善良， 美德， 好意
lightning|闪电， 电光
jaw|颌， 颚
margin|页边空白； 差数， 差额； 余地； 边缘
remain|剩下，余留；保持；仍然是 n. 残余； 残骸； 遗迹
amaze|使惊奇， 使惊愕
refine|精炼， 精制， 提纯； 使优美， 使完善
mount|登上；发起；安放；增加，加剧 n. 山， 峰
demand|要求， 需要； 查问
mystery|神秘； 神秘的人
atomic|原子的， 原子能的， 原子武器的
deposit|使沉淀；存放，储蓄 n. 定金， 押金； 存款； 矿藏
centimetre|公分， 厘米
telescope|望远镜
rotten|腐烂的； 令人不愉快的； 糟糕的
skillful|灵巧的， 娴熟的
flash|闪， 闪烁； 飞驰 n. 闪光；闪光灯
accuse|指责， 归咎于
housing|房屋， 住宅； 住房建筑， 住房供给； 外壳， 外罩
devil|魔鬼， 恶魔； 家伙， 人
guarantee|保证；保证书；担保物 vt. 保证， 担保
recommend|推荐， 举荐； 劝告， 建议； 使成为可取； 使受欢迎
acquire|取得， 获得， 学到
fertile|肥沃的； 多产的； 丰富的
automobile|汽车， 机动车
notion|概念， 观念； 意图， 想法， 念头
diversity|多样性； 差异； 不同点
helicopter|直升机
tractor|拖拉机， 牵引车
patience|忍耐， 耐心
grace|优美，优雅；风度，魅力；宽限，缓期 vt. 使优美
advertisement|广告， 公告， 登广告； 广告活动， 宣传
ripe|熟的； 时机成熟的
attribute|把…归因于 n. 属性
mechanism|机械装置； 机制， 机理； 办法， 途径
detection|察觉， 发觉； 侦查， 探测
triumph|成功 n. 凯旋，胜利
vice|罪恶； 恶习， 缺点； 虎钳
horror|恐怖； 憎恶； 令人恐怖的事物
poison|毒，毒药 vt. 毒害
thoughtful|沉思的； 体贴的
gram|克
empower|授权于； 使能够
riot|聚众闹事 n. 暴乱，骚乱；极度丰富 vt. 把浪费在放荡的生活上
arouse|引起； 唤起， 唤醒
nest|筑巢 n. 巢，窝，穴
tour|n&vi. 旅行， 游历
calm|静的，平静的 v. 平静， 镇静
boring|令人厌烦的， 乏味的， 无聊的
classic|最优秀的，典型的，标准的；传统式样的，典雅的 n. 文学名著， 经典作品， 杰作； 优秀的典范； 古典文学， 古典语文研究
ownership|所有， 所有制
metric|公制的， 米制的
absolute|十足的， 地道的； 绝对的， 完全的； 不受任何限制的
ash|灰， 灰末； 骨灰
describe|形容； 描写； 画出
suck|吸， 吮， 啜； 吸收
grab|抓取，攫取；赶紧做；抓住；抓，夺 n. 抓， 夺
rub|擦， 摩擦
presently|不久， 一会儿； 现在， 目前
wealthy|富有的， 富裕的
rug|地毯
jazz|爵士音乐， 爵士舞曲
dusk|薄暮， 黄昏； 幽暗
administration|管理； 管理部门， 行政机关； 实行， 执行
occasional|偶尔的， 间或发生的
boast|自夸；自豪 vt. 自夸，吹嘘；以拥有…而自豪 n. 自吹自擂， 自夸的话
operator|操作人员； 话务员， 报务员
debate|n&v. 争论， 辩论
spacecraft|航天器， 宇宙飞船
furniture|家具
segment|部分， 片段； 瓣
stripe|条纹
jet|乘喷气式飞机 n. 喷气式飞机；喷嘴；喷射
helpful|给予帮助的； 有用的
statistic|统计数值， 统计资料； 统计学
attractive|有吸引力的， 引起注意的
superb|极好的； 高质量的
mold|霉，霉菌；模型，铸模；性格 vt. 用模子制作， 塑造； 使形成， 影响…的形成
engineering|工程， 工程学
significant|相当数量的； 重要的， 意义重大的， 意味深长的
bold|勇敢的； 鲁莽的； 粗体的， 黑体的； 醒目的
bleed|出血， 流血； 泌脂 vt. 勒索…的钱
delicious|美味的； 芬芳的， 怡人的； 有趣的
catalogue|目录 v. 为…编目录，把…列入目录中
whatever|[用于否定句中以加强语气]任何； 无论什么
decrease|减少 n. 减少
volunteer|自愿提供； 自愿， 志愿 n. 志愿者；志愿兵
museum|博物馆
ignorance|无知， 愚昧
senate|参议院， 上院
trumpet|喇叭，小号 vt. 大声宣告， 鼓吹
bolt|螺栓，插销 vt. 闩门
string|连成一串； 排成一行前进 n. 线，细绳；一串，一行 vt. 缚，扎，挂；串起，穿；使排成一列；伸展，拉直
import|输入， 进口 n. 输入， 进口； 进口商品； 意义， 重要性
occupy|占领， 占， 占有
submit|屈从， 听从， 服从 vt. 呈送，提交；主张，建议；使服从，使降服
mood|心情， 情绪； 语气
boom|激增， 繁荣， 迅速发展； 发出隆隆声 n. 激增，繁荣，迅速发展；隆隆声，嗡嗡声
absence|缺席， 不在； 缺席的时间， 外出期； 缺乏， 不存在
attract|吸引， 引起…注意
edition|版， 版本， 版次
simplicity|简单， 简易； 朴素
cautious|十分小心的， 谨慎的
disappear|不见， 失踪， 消失
summit|最高点， 峰顶； 最高级会议
recession|衰退， 衰退期
conclusion|结论， 推论； 结尾； 缔结， 议定
typist|打字员
durable|耐久的， 耐用的
negative|否定的，消极的；负的；阴性的 n. 负片， 底片； 负数
impose|利用， 占便宜； 欺骗 vt. 把…强加于；征
ally|结盟， 联合 n. 同盟国， 同盟者； 支持者
statement|陈述， 声明； 结算单， 报表
hence|因此， 所以； 今后
memorial|纪念的，悼念的 n. 纪念碑， 纪念堂， 纪念仪式
factor|因素； 因子； 系数
boot|靴子， 长筒靴； 行李箱； 解雇
pinch|捏，拧 n. 撮， 微量
delivery|投递， 交付； 分娩； 讲话方式； 投递的邮件
rack|挂架，搁架 vt. 使痛苦， 折磨； 尽力使用
election|选举； 选择权； 当选
conquer|征服， 战胜； 破除， 克服
learned|有学问的； 学术上的
substance|物质； 实质； 大意， 要旨； 根据， 理由
frown|n&vi. 皱眉， 蹙额
bond|黏合， 结合 n. 联结，联系；公债；契约，合同
target|目标 vt. 把…作为目标； 瞄准
wax|蜡，蜂蜡 vt. 给…上蜡
grind|磨， 磨快
urban|城市的， 都市的； 住在都市的
furthermore|而且， 此外
guidance|引导， 指导， 领导
risk|危险，风险；引起危险的事物 vt. 冒…的危险， 使遭受危险
flame|火焰， 光辉； 热情
container|容器； 集装箱
leader|领袖， 领导人， 首领
delicate|纤细的， 易碎的； 微妙的； 精美的
discard|丢弃， 抛弃， 遗弃
fancy|昂贵的； 别致的 n. 想象力，设想；爱好 vt. 喜欢；想象，猜想
rebel|反叛， 造反； 反对， 不服从 n. 反叛分子， 反对者
bounce|弹起，反弹；颠簸 n. 弹， 反弹
usage|使用； 对待； 惯用法
tissue|组织； 薄绢， 薄纸， 手巾纸
experimental|实验的， 试验的
loosen|解开； 放松， 松弛
rent|租借，租用；出租，出借 n. 租金； 出租
nearby|在附近 adj. 附近的
carpenter|木工， 木匠
cart|运货马车
modest|谦虚的； 适中的； 羞怯的
cast|投，扔，抛；浇铸 n. 演员表， 全体演员； 石膏绷带； 铸型， 铸件； 投， 抛
anxious|忧虑的， 令人焦急的； 渴望的
hatred|憎恶， 憎恨， 仇恨
crush|压碎， 碾碎； 摧毁， 压垮
largely|大部分， 大量地
slice|薄片，切片；部分 vt. 切， 削
frost|结霜 n. 冰冻，严寒；霜
electron|电子
incline|倾斜； 弯； 倾向于 n. 斜坡
truly|真正地； 忠实地
cash|现金，现款 vt. 把…兑现
counsel|律师，法律顾问；忠告，劝告 vt. 劝告， 提议
item|条， 条款， 一条
gene|基因
liver|肝
suicide|n&v. 自杀
violet|紫色的 n. 紫罗兰
hollow|空的， 空洞的； 沉闷的； 虚伪的
trunk|树干； 大衣箱， 皮箱； 汽车后备箱； 象鼻
saving|节省， 节约； 储蓄金， 存款
rely|依靠， 依赖； 信赖， 指望
hospitalize|就医
slide|滑；悄悄地移动 n. 滑动； 滑道， 滑面； 幻灯片
utilize|利用
sticky|黏性的， 胶黏的； 湿热的
prevail|流行， 盛行
waist|腰， 腰部
excessive|过多的， 极度的
flesh|肉， 肌肉， 肉体
jungle|丛林， 密林， 莽丛； 乱七八糟的一堆
portion|一部分，一份 vt. 分配， 把…分给
settle|安排， 安放； 调停； 支付， 核算； 安家； 飞落， 停留； 安定
pattern|型，式样，模型 vt. 仿制， 使照…样子
harsh|严厉的； 粗糙的
connexion|connection的英式拼法
vehicle|车辆， 机动车； 传播媒介， 工具， 手段
scrape|刮，擦 n. 刮， 擦； 刮擦声
hardship|艰难， 困苦
confuse|使困惑， 把…弄糊涂； 混淆， 把…混同； 混乱， 搞乱
cushion|垫子， 坐垫， 靠垫
scold|责骂， 训斥
glorious|光荣的； 壮丽的； 令人愉快的
civilize|使文明， 使开化， 教育
physician|内科医生
architecture|建筑学； 建筑式样， 建筑风格
stress|压力；强调；重要性；应力；重音 vt. 强调， 着重； 重读
grip|握紧，抓牢；吸引住 n. 紧握
explore|探险， 探索； 仔细查阅， 探究
display|陈列， 展览， 显示
electricity|电
climate|气候； 风土， 地带； 风气， 气氛
conductor|售票员， 列车长； 指挥； 导体
bore|使厌烦；钻，挖 n. 令人讨厌的人
crust|面包皮， 硬外皮； 外壳， 地壳
disorder|混乱， 杂乱， 骚乱
criticize|批评； 评论； 非难
organization|组织， 团体， 机构
rage|狂吹； 汹涌； 激烈进行； 发怒， 发火 n. 狂怒，盛怒；风靡一时的事物，时尚
width|宽阔， 广阔； 宽度
dairy|乳制品的 n. 牛奶场；乳制品
board|搭伙； 膳宿 n. 板，牌子；木板，纸板；委员会，董事会；伙食 vt. 上
economic|经济的，经济学的 n. 经济学； 经济状况
stuff|材料，东西 vt. 装， 填， 塞； 让…吃饱
arrest|逮捕，拘留；停止，阻止；吸引 n. 逮捕， 拘留， 扣留
widow|寡妇
distinction|差别， 不同， 区分
mature|成熟的；成年人的；深思熟虑的；到期的，应支付的 vt. 使成熟
navy|海军
fee|费； 酬金， 赏金
section|部分， 章节； 部门， 科； 截面， 剖面
influence|影响，作用；影响力，势力；产生影响力的人 vt. 影响
whip|鞭笞；猛地移动；搅打成糊状 n. 鞭子
protocol|礼仪， 礼节； 草案， 议定书
whale|鲸
provoke|对…挑衅， 激怒； 激起， 引起
threaten|威胁， 恐吓； 预示快要来临， 是…的征兆； 构成威胁； 可能发生
talent|天才， 才能； 人才
percentage|百分比， 百分率
negotiate|洽谈， 协商； 顺利通过， 成功越过； 协商， 谈判
strain|扭伤， 拉伤； 尽力； 拉紧 n. 拉紧；过劳；极度紧张；张力；扭伤，拉伤；旋律；品种，家系；气质，个性特点
hunt|打猎； 搜寻； 驱逐
violin|小提琴
remonstrate|抗议
package|包裹，包装；一揽子交易 vt. 把…打包； 包装
visible|可见的， 看得见的， 有形的
crisis|危机， 存亡之际； 关键阶段
rail|责骂， 抱怨 n. 栏杆，横杆；铁轨，轨道；铁路
survival|幸存； 幸存者， 残存物
germ|微生物， 细菌； 幼芽
inner|内部的； 内心的
market|市场； 股市； 行情， 销路
keen|热心的； 激烈的； 敏锐的， 敏捷的
glimpse|看一眼，一瞥 vt. 瞥见 n. 一瞥， 一看
detective|侦探， 私人侦探
transfer|搬， 转移； 调动， 转学； 转让， 过户； 乘车， 转乘
footstep|脚步， 脚步声， 足迹
veteran|老兵， 老手
indifferent|冷漠的， 不积极的； 一般的， 平平的
outside|外部的 prep. 在…的外面； 向…的外面； 除…以外 n. 外部，外表
nerve|神经； 勇敢， 胆量
affection|感情； 爱， 爱慕
eagle|鹰
cruise|航游，巡航；缓慢巡行 n. 航游， 游弋
elementary|基本的， 初级的
topic|题目， 论题， 话题
solemn|庄严的， 隆重的； 严肃的
perceive|感知， 感觉， 察觉； 认识到， 意识到； 理解
omit|省略； 遗漏
embarrass|使窘迫， 使为难
option|选择， 选择权， 选择自由； 选择的事物或人， 选课
erroneous|错误的， 不正确的
raid|n&vt. 袭击； 突入查抄， 突入搜捕； 劫掠
politics|政治， 政治学； 政纲， 政见
acute|严重的； 急性的； 灵敏的， 敏锐的； 精明的
limitation|限制， 限度； 局限
sponsor|发起者 vt. 发起； 资助， 赞助； 支持
kindergarten|幼儿园
unexpected|想不到的， 意外的
crucial|至关重要的， 决定性的
contribute|捐献， 捐款； 投稿
faith|信任； 信心； 信仰， 信条； 忠诚
generator|发电机； 发生器
insert|插入， 嵌入； 登载
remark|说；评论说 n. 话语； 谈论， 评论
forbid|禁止， 不许， 阻止
microscope|显微镜
necessarily|必要地； 必然
highlight|强调，突出，使显著 n. 最精彩的部分； 最重要的事件
candidate|候选人； 投考者， 申请求职者
billion|十亿
parallel|平行的；类似的；并列的，并联的 n. 可相比拟的事物；相似处；平行线，平行面；纬线 vt. 与…平行； 与…相似， 与…相当， 比得上
reject|拒绝； 拒纳， 退回 n. 次品
patient|忍耐的，有耐心的 n. 病人
cashier|出纳
sheer|垂直地，陡峭地 vi. 急转向， 偏离 adj. 完全的，十足的；陡峭的，垂直的；极薄的，透明的
miracle|奇迹， 令人惊奇的人
profit|受益 n. 益处；利润，收益 vt. 有益于，有利于
original|最初的；新颖的；原版的 n. 原件， 原作
wit|风趣； 妙语； 智力， 才智， 智能
handful|一把， 少数， 一小撮
assignment|任务， 指定的作业； 分配， 指派
nylon|尼龙
yawn|打呵欠 n. 呵欠
electric|电的， 电动的
terminal|晚期的，不治的；末端的，终点的，极限的 n. 终点； 终端； 接线端
kingdom|王国； 领域； 界
differ|不同， 相异； 发生分歧
various|各种各样的， 不同的
latter|后者的； 后一半的
depression|抑郁， 沮丧； 不景气， 萧条； 洼地， 凹陷
reduction|减少， 缩小； 下降， 降低
extent|广度； 范围； 程度
equivalent|相等的，等量的 n. 相等物， 等价物
gaol|监禁 n. 监狱
conversely|相反
sauce|调味汁， 作料
ban|取缔，查禁；禁止 n. 禁止， 禁令
fascinate|有吸引力， 迷人 vt. 迷住，强烈吸引
suffer|遭受， 忍受， 容许； 受痛苦， 受损
diplomatic|外交的， 从事外交的； 策略的， 有手腕的
bat|蝙蝠； 球棒， 球拍
neighbourhood|四邻； 附近； 接近
draft|草稿；汇票；征兵；通风 vt. 起草； 征募
complex|由许多部分组成的， 复合的； 复杂的， 难懂的
rank|给…评定等级； 列入， 占特定等级 n. 军衔，职衔；地位，社会阶层；排，行列
assumption|假定， 臆断； 担任， 承担
pension|养老金，抚恤金 vt. 发给…养老金
giant|巨大的 n. 巨人，巨物；才智超群的人
fluid|流动的 n. 流体，液体
bay|湾； 分隔间
outlet|出口， 出路； 发泄途径
neglect|疏于照料；疏忽 n. 疏忽
addition|加， 加法； 附加物
gang|聚集， 结成一伙 n. 一帮，一伙
shrink|起皱； 收缩； 退缩， 畏缩
ancestor|祖宗， 祖先； 原型； 先驱
textile|纺织的 n. 纺织品；纺织业
former|在前的 n. 前者
panic|恐慌， 惊慌失措 n. 恐慌，惊慌，慌乱
extend|延长， 扩大； 提供， 给予； 伸展， 达到
fold|折叠，合拢 n. 褶， 折叠的部分
plastic|塑料的；可塑的 n. 塑料， 塑料制品； 信用卡
globe|地球， 世界； 地球仪； 球体
chemical|化学的 n. 化学制品
interpretation|解释； 口译； 艺术处理
ax|斧子
intermediate|中间的； 中级的
folk|人们； 家属， 亲属； 大伙儿， 各位
consideration|考虑， 思考， 要考虑的事； 体贴， 关心
competitive|竞争的， 比赛的； 好竞争的， 求胜心切的； 有竞争力的
enquiry|询问
applause|鼓掌， 掌声
frank|坦白的， 直率的
abuse|滥用； 虐待， 伤害； 辱骂， 毁谤 n. 滥用； 虐待， 伤害； 辱骂， 毁谤
prove|证实， 证明； 结果是
scheme|密谋， 策划 n. 计划，方案；阴谋
affect|影响； 感动
deaf|聋的； 不愿听的
admire|钦佩， 羡慕； 赞赏， 称赞， 夸奖
consequently|因此， 因而， 所以
virus|病毒； 病毒性疾病， 病毒病
drain|排去，放水 n. 耗竭； 排水沟， 排水管
isolate|使隔离， 使孤立
sailor|水手， 海员
amuse|逗…乐， 给…娱乐
inward|向内 adj. 里面的；内心的
responsibility|责任， 责任心； 职责， 义务
enquire|询问
civil|公民的； 文职的； 民用的； 民事的， 民法的； 文明的
popularity|普及， 流行； 声望
subsequent|随后的， 后来的
indicate|标示， 表示， 表明
scarcely|几乎不， 简直不； 决不； 刚刚， 才
panel|专门小组； 面， 板； 控制板， 仪表盘
outstanding|突出的， 杰出的； 未解决的； 未偿付的
charge|索价；控告；充电，充满；向前冲 n. 费用； 管理； 控告， 指责； 电荷， 充电
sew|缝制， 缝纫
oval|椭圆形的 n. 椭圆形
column|柱， 支柱， 圆柱； 纵队； 栏， 专栏
procedure|程序， 手续， 步骤
sample|样品，试样，样本 vt. 从…抽样； 品尝， 体验
integrate|成为一体， 合并
survivor|生还者； 残存物
applicant|申请人
tropical|热带的； 炎热的
partner|做…的搭档 n. 伙伴，合伙人，搭档，配偶
plunge|n&v. 纵身投入， 猛冲； 猛跌
diagnose|诊断
somewhat|有点儿 pron. 一点儿
earnest|认真的， 诚恳的
spider|蜘蛛
interview|n&vt. 接见， 会见； 面谈， 面试； 采访
essential|必要的；本质的 n. 要素； 必需品
clarify|澄清， 阐明
furnace|炉子， 熔炉， 鼓风炉
ditch|沟， 沟渠， 渠道
deck|甲板， 舱面； 层面
scare|吓， 使害怕； 受惊吓， 感到害怕 n. 惊恐，恐慌
thunder|打雷， 轰隆响； 大声喊， 吼 n. 雷，雷声；擂鼓般的响声，轰隆声
observe|注意到， 观察； 评说； 遵守
humorous|幽默的， 诙谐的
furnish|供应， 提供； 装备
bet|打赌；敢说，确信 n. 打赌； 赌金， 赌注
contact|接触；联系，交往 vt. 与…接触， 与…取得联系
rare|稀有的， 冷僻的； 珍奇的； 出类拔萃的； 稀薄的； 煎得嫩的
discharge|释放， 排出； 卸货 n. 释放， 放电
exclude|把…排除在外
scary|引起惊慌的
criticism|批评， 批判； 评论， 评论文章
utmost|最远的 n. 极限
image|像； 形象； 映像； 形象的描述
consultancy|咨询公司
ribbon|缎带， 丝带； 色带
garbage|垃圾， 废物； 废话； 无用的资料
complain|抱怨， 诉苦； 控告， 投诉
mainland|大陆
homogeneous|同种类的， 同性质的， 有相同特征的
anxiety|焦虑， 忧虑； 渴望， 热望
temptation|诱惑， 引诱
adjust|调整， 调节， 校正
popularize|普及
burst|爆裂，爆炸；挤满；突然打开；突然发作 vt. 使爆炸；突然打开 n. 爆炸
vigorous|朝气蓬勃的； 有力的， 用力的
debt|债， 债务， 欠债
refrigerator|冰箱， 冷藏库
necessity|必需品； 必要性， 需要
fog|雾， 烟雾， 尘雾
frame|框架，框子，构架 vt. 给…镶框； 陷害， 诬告； 制定； 表达
lucky|幸运的， 侥幸的； 吉利的
origin|起源， 起因； 出身， 血统
industrialize|工业化
clash|发生冲突；不协调；砰地相撞，发出刺耳的撞击声 n. 冲突； 不协调； 刺耳的撞击声
compel|强迫， 迫使屈服
capable|有能力的， 有才能的
depress|使沮丧； 使不景气； 削弱， 抑制
parade|游行， 列队前进； 招摇而行 n. 游行；检阅
burden|重担，精神负担 vt. 加重压于， 烦扰； 负担， 装载
precaution|预防； 防备， 警惕
lemon|柠檬； 柠檬树； 柠檬黄， 淡黄色
personality|人格， 个性； 人物， 名人
plot|密谋， 计划； 绘制…的平面图， 在图上标绘…的位置 n. 故事情节；计划，密谋；小块土地
sanction|批准，认可 n. 批准， 认可； 约束因素， 约束力； 国际制裁
rate|被评价； 被列入特定级别 n. 速度，速率；比率；价格，费用；等级 vt. 评估；给…定级，把…列为；值得，应得
alert|警觉的，留神的，注意的 vt. 使认识到，使意识到 n. 警戒， 戒备； 警报
await|等候； 期待； 将降临到…身上
sin|犯戒律， 犯过失 n. 罪，罪孽
client|委托人， 当事人， 顾客
prosperity|繁荣， 兴旺
divide|分，分开；分配，分享；除；产生分歧 n. 分歧； 分界线， 分水岭
contrary|相反的 n. 相反
lump|结块； 将…归并在一起 n. 块，肿块
digital|数字的， 数位的
brilliant|光辉的； 卓越的
historic|历史上著名的， 具有重大历史意义的
oven|炉， 烤箱
bound|跳跃；弹回，反跃 adj. 一定的；有义务的 vt. 跳跃；弹回，反跃；成为…的界限，给…划界 n. 跳跃； 界限， 限制
counter|柜台； 计数器； 筹码
rhythm|韵律， 节奏
stroke|中风；一举，一次努力；划桨，划水；击，敲；报时的钟声；笔画，一笔；抚摸 vt. 抚摸
breed|繁殖； 养育， 培育； 酿成， 产生 n. 品种
management|管理； 处理； 管理部门； 管理人员
publish|公布， 发表； 出版， 刊印
realm|界， 领域， 范围； 王国， 国度
correspondent|通讯员， 记者
avoid|避免， 躲开； 撤销
renew|重新开始， 继续； 更新； 恢复； 延长有效期
bid|企图，努力；喊价，出价，投标 vt. 喊价， 投标， 出； 祝， 表示； 命令
prompt|敏捷的，及时的 vt. 促使，推动；提示 n. 提示台词， 提示
astonish|使惊讶， 使吃惊
comprehensive|广泛的， 综合的； 理解的
tunnel|挖， 开 n. 隧道，坑道，地道
withdraw|收回， 撤回； 撤退
assign|指派， 分配， 布置； 指定
elaborate|复杂的； 精心制作的 v. 详述， 详细制订
feather|羽毛， 翎毛
corridor|走廊， 回廊， 通路
decade|十年， 十年期
expert|熟练的 n. 专家
select|精选的， 挑选出来的； 优等的， 第一流的 vt. 选择，挑选
fulfill|履行， 实现， 完成； 满足， 使满意
crowd|聚集； 挤满； 挤； 推 n. 群，一批
congress|代表大会； [C-]国会， 议会
advanced|先进的； 高级的； 年迈的； 后阶段的
mechanical|机械的， 机械制造的； 机械学的， 力学的； 呆板的
recommendation|推荐， 推荐信； 建议； 优点， 可取之处
welfare|幸福； 福利， 福利救济
flourish|繁荣，茂盛，兴旺 vt. 挥动
output|产量；输出；输出功率 vt. 输出
fatigue|疲劳 n. 疲劳，劳累
striking|显著的， 突出的； 惹人注目的， 容貌出众的
vessel|容器； 船； 飞船； 管
majority|多数， 大多数
drag|拖，拉；迫使，硬拉；拖着脚步走 n. 累赘； 一吸， 一抽
crown|王冠， 冕
likely|可能 adj. 可能的；适合的
inquire|打听， 询问； 调查
gymnasium|体育馆， 健身房
issue|发行， 分发， 发出 n. 问题；发行，分发
vain|徒劳的； 自负的
lower|较低的；下面的 vt. 放下， 降低
index|索引； 指数， 指标
fry|油煎， 油炸， 油炒
youngster|青年， 年轻人， 孩子
odd|奇特的； 临时的； 奇数的； 单只的； 剩余的， 挂零的
lung|肺
conservation|保存； 保护； 守恒
distraction|分心的事； 心烦意乱； 精神错乱； 娱乐， 消遣
supplement|增补， 补充； 增刊， 副刊 vt. 增补， 补充
contrast|形成对比， 对比之下显出区别 n. 对比， 对照； 反差 vt. 对比，对照
paragraph|段， 节
judgement|意见； 审判； 判断
proportion|比例； 部分， 份儿； 均衡， 相称
widen|加宽， 变宽
crystal|水晶， 结晶体， 晶粒
occurrence|发生， 出现； 发生的事件
inflation|通货膨胀； 膨胀
thinking|深思的， 有理性的 n. 想法，意见，见解
cycle|循环（周期） v. 骑自行车
disposal|丢掉， 销毁； 处理； 排列， 布置
settlement|解决； 协议； 居留地
delegate|代表， 代表团成员 vt. 委派…为代表； 授 ， 把…委托给
literature|文学， 文学作品； 文献， 图书资料
sphere|球， 球体； 范围
inquiry|询问， 打听； 调查
prejudice|偏见，成见 vt. 使有偏见； 对…不利， 损害
dissolve|溶解； 解散； 消失， 减弱； 结束
digest|消化； 领会 n. 文摘； 摘要
angle|角， 角度； 观点， 立场
immigrant|移民， 侨民
tradition|传统， 惯例
ability|能力， 本领； 才能， 才智
urgent|紧急的， 急迫的
belief|信任， 相信； 信念
bundle|捆，包，束；包袱 vt. 收集， 归拢； 把…塞入
suggestion|建议， 意见； 细微的迹象； 暗示
systematic|有系统的， 有计划的
cupboard|柜橱； 碗碟橱， 食橱
generally|一般地， 通常地； 普遍地
bacon|咸肉
likewise|同样地； 也， 又
slender|细长的， 苗条的； 微薄的， 不足的
troublesome|令人烦恼的， 麻烦的
instruction|命令， 指示； 用法说明； 教学， 教导
oral|口头的； 口的
married|已婚的； 婚姻的
transaction|办理， 处理； 交易， 业务； 会报， 学报
conscious|意识到的， 自觉的； 神志清醒的； 有意的， 存心的
fur|软毛， 毛皮， 裘皮； 毛皮衣服
auto|汽车
sigh|叹气， 叹息 n. 叹息
constant|经常的，不断的，连续发生的；永恒的；忠实的，忠诚的 n. 常数， 恒量
pants|长裤， 便裤； 内裤
mislead|给…错误印象， 使误解； 把…带错路； 使误入歧途
split|分裂，分离；被撕裂，裂开；分担，分享 n. 裂口
orchestra|管弦乐队
publication|出版， 发行； 公布， 发表
sufficient|足够的， 充分的
claim|声称，主张；对…提出要求，索取；以…为其成果；需要，值得 n. 要求， 认领， 索赔； 声称； 断言
antique|古时的， 过时的 n. 古物，古董
sow|播， 播种
widespread|分布广的， 普遍的
petroleum|石油
communication|通讯， 交流， 交际； 通信工具， 交通联系
directly|直接地； 正好地， 截然； 立即
tolerance|忍受， 容忍， 忍耐力； 公差
kneel|跪， 跪下， 跪着
porter|搬运工人； 看门人， 大楼管理员
fasten|扎牢， 扣住
contest|竞赛， 争夺 vt. 争夺， 与…竞争； 对…提出质疑， 辩驳
author|著作家， 作者
dirt|灰尘， 土； 污物， 污垢
astrophysics|天体物理学
greenhouse|温室， 暖房
preserve|保护， 维持； 保存； 腌制
plus|表示加的；正的 prep. 加，加上 n. 加号， 正号
establish|建立， 设立； 确立； 证实
expansion|扩大， 扩充， 扩张， 膨胀
relevant|有关的， 切题的
entry|入口处； 登记； 进入； 参赛者名单； 条目
license|许可，执照 vt. 准许
synthetic|综合的， 合成的； 虚假的
headquarters|司令部， 总部
expand|扩大， 使膨胀
gaze|n&vi. 凝视， 盯， 注视
essay|短文， 散文， 小品文
survey|俯瞰； 检查； 测量 n. 调查， 勘察； 测量， 勘测； 全面审视， 概括论述
plug|插头，插座；塞子，栓 vt. 把…塞住， 用…塞住
bunch|集中， 挤在一起； 形成一束 n. 群，伙；束，串，捆 vt. 使成一束
thermometer|温度计， 寒暑表
tense|拉紧的；紧张的 v. 拉紧， 绷紧 n. 时态
postpone|延迟， 延期
bride|新娘
favourable|有利的， 赞成的； 顺利的
hammer|锤击 n. 锤，榔头
candy|糖果
seal|封铅，封条；印，图章；海豹 vt. 封
mental|心理的， 精神的， 思想上的； 精神病的； 智力的
decent|像样的， 过得去的， 体面的； 宽厚的， 大方的； 正派的； 合乎礼仪的， 得体的
storage|贮藏； 贮藏量
investigate|调查， 研究
racial|种族的， 人种的
switch|转换， 改变 n. 开关，电闸；转换，改变
niece|侄女， 外甥女
considerable|相当大的； 重要的
auxiliary|辅助的， 附属的； 后备的
heal|愈合， 痊愈， 恢复健康 vt. 使愈合，治愈，使康复；调停，消除
reserve|保留，留存；预订 n. 储备； 保留； 拘谨， 矜持； 替补队员， 后备部队； 自然保护区
somehow|由于某种原因， 不知怎么的； 以某种方式
dive|跳水； 潜水； 俯冲
brick|砖， 砖块， 砖状物
sympathy|同情； 一致， 支持， 赞同
heap|堆， 大量
consumer|消费者， 用户， 消耗者
rescue|n&vt. 营救， 救援
cripple|跛子；残疾人 vt. 使跛； 使残疾
highly|高度地， 极， 非常赞许地
brief|简短的，短暂的 vt. 向…介绍基本情况，做…的提要 n. 概要， 摘要
keyboard|键盘
initiative|主动性； 首创精神； 主动的行动， 倡议； 主动权
recover|重新获得， 挽回； 恢复
determine|决意 vt. 决定；查明；使下决心
nature|大自然； 本性； 性质
social|社会的； 交际的， 社交的
medication|药物治疗； 药物
drill|钻， 打； 训练 n. 钻头；操练，训练
intelligent|聪明的， 理智的
whilst|当…的时候
clerk|店员， 办事员， 职员
lobby|向进行游说 n. 大厅；休息室；院外活动集团
acknowledge|承认， 承认…的权威； 告知收到， 确认； 对…表示感谢， 报偿
equip|装备， 配备； 使有准备
radiation|放射物， 辐射能； 辐射
christian|基督教的 n. 基督教徒，信徒
pulse|搏动， 跳动 n. 脉搏；脉冲
luxury|奢侈； 奢侈品
spiritual|精神的， 心灵的； 宗教的
worthwhile|值得花时间的， 值得做的
mould|霉，霉菌；模型，铸模；性格，气质 vt. 用模子做， 浇铸； 使形成， 把…铸造成
increasingly|日益， 越来越多地
elbow|肘，肘部 vt. 用肘部， 用肘挤
salad|色拉， 凉拌菜
strategic|对全局有重要意义的， 关键的； 战略的
vary|改变； 多样化
readily|乐意地， 欣然地； 容易地； 很快地， 立即
stoop|俯身，弯腰；堕落，自贬 n. 弯腰， 曲背
upper|上面的， 地位较高的
rocket|迅速上升， 猛涨 n. 火箭
splendid|壮丽的； 极好的
county|郡， 县
respondent|回答者； 响应者； 被告
episode|一个事件； 插曲， 片段； 连续剧的一集
convenience|方便； 便利设施
determination|决心， 决定； 确定
discipline|纪律；训练；惩罚；学科 vt. 训练； 惩罚， 处罚
behalf|利益
evidently|明显地， 显然
objective|客观的， 无偏见的 n. 目标，目的
injure|伤害， 损害， 使遭受损伤
victimize|使受害， 使牺牲
exert|尽； 运用
province|省； 领域， 范围
scandal|丑事， 丑闻； 流言蜚语； 反感， 愤慨
horrible|令人恐惧的， 可怕的； 骇人听闻的； 极讨厌的， 使人不愉快的； 糟透的
estimate|估计； 评价 n. 估计； 评价， 看法
strengthen|加强， 巩固
drip|滴下，漏水 n. 水滴； 滴水声
injury|损害， 伤害； 受伤处
exhibit|显示；陈列，展览 n. 展览品
brand|品牌；烙印 vt. 铭刻， 打烙印于； 加污名于， 谴责
mushroom|迅速成长 n. 蘑菇
alcohol|酒精， 乙醇
choke|使窒息； 塞满， 塞住
proposal|提议， 建议； 求婚
inevitable|不可避免的， 必然的
deny|否定， 否认； 拒绝…的要求
miserable|痛苦的； 悲惨的； 令人难受的
recreation|娱乐活动， 消遣
subtract|减， 减去， 去掉
allowance|津贴， 补贴； 零用钱
portable|便于携带的， 手提式的
ancient|古代的， 古老的； 年老的， 看上去很老的
glory|光荣， 荣誉的事； 美丽
secondary|次要的， 第二的； 中等的； 辅助的， 从属的
mission|使命， 任务； 使团
attorney|律师， 代理人
wander|漫游， 闲逛， 漫步； 偏离正道； 走神， 恍惚
adopt|收养； 采用， 采取； 正式通过， 批准
oppose|反对； 反抗
singular|单数的； 非凡的， 奇特的； 独一无二的
device|器械， 装置， 设备； 手段， 策略
mainframe|主机， 大型机
motor|发动机， 电动车
minus|负的 prep. 减 n. 负数；减号
conservative|保守的，守旧的；不时兴的，传统的 n. 保守的人
access|接近；通道，入口；接近的机会 vt. 存取
conference|会议， 讨论会； 讨论， 商谈
activity|活动； 活力； 行动
primitive|原始的，早期的；简单的；粗糙的 n. 原人； 原始事物
advisable|明智的， 可取的
dormitory|集体寝室， 宿舍
overcome|战胜， 克服； 压倒， 使受不了
cooperate|合作， 协作； 配合
cabin|小屋； 船舱， 机舱
sum|共计 n. 总数；金额；算术
current|当前的， 通用的； 流行的， 流传的
heel|脚后跟， 踵； 后跟
variety|多样化； 种类； 变种
disturb|打扰， 扰乱； 弄乱； 使不安
copper|铜； 铜币， 铜制器
persist|坚持， 持续
audio|听觉的， 声音的
civilian|平民， 百姓
pump|泵 vt. 抽， 泵送， 打气
pierce|刺穿， 穿孔于
teenager|青少年
apart|成距离，相间隔；分开，除去 adj. 分离的， 分隔的
calendar|日历， 历书， 历法
offensive|冒犯的，无礼的；进攻的，攻击性的 n. 进攻， 攻势
cartoon|卡通画， 幽默画； 动画片， 卡通片
speculate|推测， 推断； 投机， 做投机买卖
launch|发射，投射，发动；使下水 n. 发射； 下水
amid|在…中间， 在…之中， 被…围绕
beloved|所钟爱的， 所爱戴的
single|单一的；独身的；单程的 n. 单程票；
confirm|证实， 肯定； 确认； 批准
cement|水泥，胶泥 vt. 黏结； 巩固， 使团结
subway|地道； 地铁
gallon|加仑
acquaint|使认识， 使了解
appoint|任命， 委任； 约定， 指定
elastic|有弹性的， 灵活的 n. 松紧带
assist|援助， 帮助， 协助
vast|巨大的， 大量的； 浩瀚的
intervene|干涉， 调停， 干预； 插入， 介入； 干扰， 打扰
undergraduate|大学本科生
symbol|象征； 符号， 标志
commercial|商业的， 商务的； 商品化的， 商业性的
joint|连接的； 共同的 n. 接头，接缝；关节
reasonable|通情达理的， 讲道理的； 合理的； 公道的； 尚好的， 过得去的
available|现成可使用的， 通用的； 可取的； 联系的； 可得到的
confine|限制， 使局限； 使不外出， 禁闭
advocate|拥护， 提倡， 主张 n. 拥护者， 提倡者； 辩护者， 律师
frequency|屡次； 次数， 频率
horizontal|地平的， 水平的
luggage|行李
lick|舔，舔吃；打败，克服；轻拍，吞卷 n. 舔； 少量， 少许
missile|导弹， 飞弹， 投射物
dynamic|有活力的；动力的；不断变化的 n. 动力； 动力学
satisfactory|令人满意的
military|军事的，军用的 n. 军队， 武装力量
reluctant|不情愿的， 勉强的
generate|发生， 引起； 生殖
unusual|不平常的， 少有的； 独特的， 与众不同的
sector|部门， 部分； 防御地段， 防区； 扇形
passion|激情， 热情； 酷爱
extreme|极度的；末端的 n. 极端， 过分
coil|卷，圈；线圈 vt. 卷
ensure|保证； 保护
coordinate|同等的， 并列的 vt. 协调， 调节 n. 坐标
organism|生物， 有机体； 机体， 有机组织
athlete|运动员， 体育家
epidemic|流行性的；传染的 n. 流行病； 传播
suppose|猜想， 假定， 让； [常用于被动语态]期望， 认为应该
upright|挺直着， 竖立着 adj. 垂直的；正直的，诚实的
remarkable|值得注意的， 引人注目的； 异常的， 非凡的
brake|制动； 刹住， 用闸使放慢速度 n. 闸，刹车
tube|管， 电子管， 显像管
naval|海军的
failure|失败， 失败的人； 失灵， 故障； 不履行
accountancy|会计工作； 会计学
forge|打制， 锻造； 伪造
carpet|地毯
solve|解答； 解释； 解决
hint|暗示， 示意 n. 暗示，示意；细微的迹象；建议
knot|打结 n. 结；节疤；节 vt. 把…打成结
demonstrate|说明； 论证； 表露
region|地区， 地带， 区域； 范围， 幅度
support|支撑；支持；供养；证实 n. 支持， 支撑物， 支持者
yearly|一年一度地 adj. 每年的
deceive|欺骗， 蒙蔽， 行骗
saucer|茶托， 碟子
hire|n&vt. 租用； 雇用
kid|戏弄， 开玩笑 n. 小孩；年轻人
donkey|驴； 笨蛋
destination|目的地， 终点， 目标
vertical|垂直的， 竖式的
learning|学习； 学问， 知识
monument|纪念碑， 纪念馆； 历史遗迹
misconception|误解
damp|潮湿的，微湿的 n. 潮湿，湿气 vt. 使潮湿； 使沮丧； 抑制
vivid|鲜艳的； 生动的， 栩栩如生的
honey|蜜， 蜂蜜； 甜， 甜蜜； [常用于称呼] 宝贝儿
screw|螺丝 vt. 固定， 拧紧
gap|缺口； 间隔； 差距； 缺陷
missing|缺掉的， 失踪的
emphasize|强调， 着重
virtue|善， 美德； 优点， 长处
normal|正常的， 平常的； 正规的， 规范的
socialist|社会主义者
gradual|逐渐的， 渐进的； 坡度平缓的
figure|出现； 合乎情理； 计算； 认为， 猜想 n. 数字；人物；算术；体形，体态；轮廓；画像，塑像；图，图形
ore|矿， 矿石
slight|轻微的，微小的 v. 侮慢；轻视，冷落
previous|先的， 前的； 以前的
transmit|传送， 传递； 传染； 播送， 发射
socialism|社会主义
consumption|消耗， 消费
argue|争辩， 争论 vt. 争论，争辩，辩论；主张；说服
technology|工艺学； 工艺， 技术
weaken|削弱， 变弱
voltage|电压
damn|该死，见鬼〔表示很生气或失望〕 adv. 非常，很 adj. 该死的〔表示对某人或某事物生气〕
superior|上级的，较高的；优越的；有优越感的，高傲的 n. 上级， 长官
location|位置， 场所； 外景拍摄地
compensation|补偿， 赔偿
bankrupt|破产的
punctual|严守时刻的， 准时的
advertise|为…做广告， 宣传； 公告； 登广告
compromise|妥协； 危及； 放弃 n. 妥协，和解，折中办法
sack|麻袋，包；解雇；洗劫，劫掠 vt. 解雇； 洗劫， 劫掠
software|软件
seminar|研究班， 研讨会
comparative|比较的， 相对的
competition|竞争， 比赛
fruitful|多产的， 肥沃的
react|反应， 作出反应
dragon|龙
hesitant|犹豫的； 吞吞吐吐的
beyond|在更远处， 再往后 prep. 在…的那边，远于；迟于；越出
hell|地狱； 极大的痛苦
feedback|回授， 反馈， 反应
hazard|危险；公害 vt. 尝试着做； 冒…风险
justify|证明…是正当的
voluntary|自愿的， 志愿的
connection|联系， 关系； 连接， 衔接； 连贯性； 熟人， 关系
proof|耐…的， 能防…的 n. 证据，证明；校样，样张
timber|木材， 原木； 大木料， 栋木
roar|吼叫，怒号，咆哮；轰鸣；大声喊出，大声表示 n. 呐喊声， 咆哮声， 吼叫声； 轰鸣
presence|出席， 到场； 存在； 仪表， 仪态
phase|阶段； 方面； 相， 相位
surrounding|附近的；四周的
efficiency|效率； 功效， 效能
overhead|在头顶上 adj. 在头顶上的，架空的 n. 经常费用， 管理费用
contract|缩小； 订合同； 感染， 染上 n. 契约， 合同
conclude|推断出， 推论出； 结束， 终了； 缔结， 议定
comprehension|理解， 理解力， 领悟； 理解力测验
beggar|乞丐 vt. 使贫穷
leather|皮革， 皮革制品
comb|梳子；鸡冠，冠状物 vt. 梳理； 在…搜寻； 彻底搜查
innovative|创新的， 革新的
insight|洞察力； 洞悉； 深刻见解
fabric|织物， 纺织品； 结构
revolutionary|革命的，革新的 n. 革命者
following|接着的，下列的 n. 一批追随者
exact|确切的，精确的 vt. 强求， 索取
indoor|在室内， 在户内 adj. 室内的
force|强迫；用力推动，用力打开 n. 军队， 兵力； 暴力， 武力； 力， 力气； 影响力， 效力
centigrade|百分度的； 摄氏的
sexual|性的， 两性的； 性别的
sympathetic|同情的； 和谐的； 赞同的， 支持的； 合意的
freight|货运；货物；运费 vt. 运送
range|变动； 漫游， 四处搜索； 使排列成行 n. 一系列；范围；射程，距离；脉；射击场
distribution|分发， 分配； 分布
tyre|轮胎， 车胎
derive|取得； 起源
capacity|容量； 能力， 才能； 能量； 身份， 地位
cope|应付， 处理
overseas|在海外 adj. 在海外的
impress|给人印象，引人注目 vt. 给…深刻印象；印，压印 n. 印记； 特征
confess|供认， 坦白； 承认
leak|漏；泄露 n. 漏洞
ghost|鬼， 灵魂， 鬼魂
feature|起重要作用 n. 特征，特色；面貌；特写，专题节目；故事片 vt. 突出；由…主演
lean|倾斜；屈身；靠 adj. 瘦的； 贫瘠的
flat|平直地； 直截了当地 adj. 平的；固定的；漏气的；平淡的；沉闷的；浅的 n. 一套房间，单元住宅
recall|回忆； 召回， 叫回； 收回， 撤销
leap|跳，跃 n. 跳跃； 骤变
waterproof|不透水的， 防水的
barber|理发师
precise|精确的， 准确的； 严谨的
sensible|明智的； 合情理的； 有知觉的
objection|反对， 异议； 反对的理由
dispute|争论， 争执； 对…表示异议 n. 争论
precious|珍贵的， 宝贵的
observation|注意， 观察； 言论， 评论； 观察资料
tremble|发抖，哆嗦；摇动 n. 颤抖； 摇晃， 摇动
suspect|可疑的， 不信任的 vt. 疑有；推测；对…表示怀疑 n. 嫌疑犯，可疑分子
apologize|道歉， 谢罪， 认错
inhabitant|居民， 住户
fraction|小部分； 片断； 分数
filter|过滤，透；走漏 n. 滤纸， 过滤嘴
sunlight|日光， 阳光
site|地点，场所 vt. 使坐落在； 设置
emotion|情感， 感情； 激动
massive|大的， 大而重的； 大块的； 大量的， 大规模的
cease|停止， 终止
assess|对估价； 评价， 评论
asset|资产， 财产； 有价值的特性或技能， 优点
owe|欠； 应把…归功于； 感激， 感恩
scarce|缺乏的， 不足的； 稀少的， 罕见的
minimum|最低的， 最小的 n. 最低限度；最小量
queue|排队等候 n. 长队，行列
mathematical|数学的
apology|道歉， 认错， 谢罪
magic|有魔力的； 魔术的 n. 魔法，魅力
argument|争论， 辩论； 理由； 说理， 论证
reveal|揭露， 泄露； 展现， 显示
data|资料，数据
theoretical|理论的
adequate|足够的； 可以胜任的
utter|完全的，彻底的 vt. 发出， 说， 讲
onion|洋葱； 洋葱类植物
vibrate|颤动
drum|有节奏地敲击 n. 鼓，鼓状物；圆桶
sausage|香肠， 腊肠
hopeful|有希望的
tremendous|极大的， 非常的； 精彩的， 了不起的
condense|冷凝， 凝结； 浓缩， 压缩， 简缩
barrier|栅栏； 检票口； 屏障； 障碍， 隔阂
realistic|现实的； 实际可行的； 现实主义的； 逼真的
justice|正义， 公正； 司法
create|创造； 引起， 产生
criminal|犯罪的， 刑事的 n. 犯人，罪犯，刑事犯
tag|尾随 n. 附加语；标签 vt. 给…加上标签
notebook|笔记本
curious|好奇的； 奇怪的
indirect|间接的， 婉转的
individual|个别的；独特的 n. 个人， 个体
resource|资源； 财力； 应付办法， 谋略
ugly|丑陋的； 可怕的
nuisance|讨厌的东西
tax|税，税款；负担 vt. 对…征税； 使负担重， 使费尽力气
earthquake|地震， 大震荡
excitement|刺激， 激动， 兴奋； 令人兴奋的事， 刺激的因素
nightmare|噩梦； 可怕的事物， 无法摆脱的恐惧
cord|细绳， 粗线， 索； 灯芯绒裤
ending|结尾， 结局； 死亡
core|果实的心； 核心， 要点
council|理事会， 委员会
enforce|实施， 执行； 强制， 强迫， 迫使
embassy|大使馆； 大使馆全体成员
departure|离开， 起程， 出发； 背离， 违背
dash|猛冲，击碎 vt. 使猛撞，飞奔；溅 n. 猛冲； 破折号
concrete|实在的， 具体的 n. 混凝土；具体物
penalty|处罚， 惩罚； 罚金
sociology|社会学
link|连接，联系 n. 环节， 联系， 纽带
flee|逃走， 逃掉， 逃离； 避开， 逃避
distinct|与其他不同的； 清楚的， 明显的
scale|大小，规模；等级，级别；天平，磅秤；比例；刻度，标度；鳞 vt. 攀登， 爬越
recovery|恢复， 痊愈； 追回， 寻回， 收复
hedge|用篱笆围； 避免直接回答 n. 篱笆，树篱；障碍物
tune|调子；和谐 vt. 调整， 调节； 为调音
weep|哭泣， 流泪； 渗出
aware|知道的， 意识到的
drama|戏剧， 剧本； 戏剧性事件
security|安全， 保障； 抵押品； 证券
limp|软的；不强壮的 v. 〔因一腿受伤而〕跛行，一瘸一拐地走 n. 跛行
award|奖，奖品；判定 vt. 授予， 给予； 判给， 裁定
organize|组织， 把…编组； 使有条理
marriage|结婚， 婚姻； 婚礼
stove|炉， 火炉， 电炉
alarm|惊恐；忧虑；警报 vt. 使惊恐； 使担心
weed|除草 n. 杂草，野草
continual|连续的； 频频的
herd|兽群，牧群 vt. 放牧
limb|肢， 臂， 腿； 树枝
balloon|气球， 玩具气球
motion|打手势， 示意 n. 运动；手势，眼色，动作；提议
limited|有限的
idle|空闲的，懒散的；无用的 v. 虚度， 无所事事
confidence|信任， 信赖； 信心， 自信
arbitrary|随心所欲的， 专断的
fearful|害怕的， 可怕的； 不安的， 忧虑的
accent|口音， 腔调； 重音
passive|被动的， 消极的
fertilizer|肥料
lorry|运货汽车， 卡车
carrier|运输工具， 运载工具； 带菌者； 载重架， 置物架
fragment|成碎片 n. 碎片，破片，碎块
corresponding|相应的， 符合的
response|回答， 答复； 反应， 响应
treaty|条约， 协议， 协定
responsive|响应的； 敏感的， 易受影响的
ounce|盎司
challenge|挑战；邀请比赛；艰巨的任务；怀疑，质问 vt. 反对， 公然反抗； 向…挑战； 对…质疑
emit|散发； 发射； 发表
category|种类， 类， 类别
rival|竞争的，对抗的 n. 竞争对手，敌手；可与匹敌的人 vt. 与 …竞争； 与…匹敌， 比得上
intend|想要， 打算； 意思是； 打算使
snap|咔嚓折断，啪地绷断；吧嗒一声；猛咬；厉声说话，怒声责骂 adj. 仓促的， 突然的 n. 吧嗒声；快照
