consistent|一致的
battery|电池
competent|能胜任的，有能力的
preserve|保存，保护
possession|拥有
proximately|近似，接近
wildfire|野火
compact|紧密的，紧凑的
defy|违背，违抗
absolutely|当然
filter|过滤
server|服务器
spoil|溺爱
rustle|发出沙沙声
diversion|转移；娱乐
complaint|抱怨，投诉
merge|合并
priceless|无价的，难以用价格衡量的
honorary|荣誉的
chronic|长期的；慢性的
extracurricular|课外的
lobby|游说
inexhaustible|用不完的，无穷无尽的
inevitable|不可避免的
contamination|污染
suspend|暂停
imminent|即将来临的
obesity|肥胖
aid|援助，有助于
solution|解决，解决方法；溶液
tuition|学费
esteem|尊重
purchase|购买
incorporate|合并
prevail|流行，普遍
irrational|不合理的，不理性的
inherent|固有的
overexcited|过于激烈的
preference|偏爱
evolution|演变；发展；进化
exotic|异域的，外国的
stockbroker|股票经理人
misinterpret|误解
prosperity|繁荣
tank|水箱
outdated|过时的
outnumber|超过
supervisor|督导
fluctuate|波动
substance|物质
profitable|有利可图的，有利益的
markedly|显著地
ineffective|无效的
bleak|荒凉的
optimistic|乐观的
ultimate|最终的
consumption|消耗；消费
foster|促进；培养
receipt|发票
harsh|严酷的，严峻的
misfortune|不幸；灾祸，灾难
citation|引文
rape|强奸
ecological|生态学的
lag|落后
controversy|争议
cornerstone|基石
erect|建立
prematurely|早熟地，过早地
initiative|主动性
dilute|稀释，冲淡
viewpoint|观点
typical|典型的
stray|走失[流浪]的动物
imbalance|不平衡
affiliation|隶属关系，单位团体
counterpart|对等物
classify|分类
demonstration|展示；游行
outlive|比……活的时间长
reservation|预定
circumstance|情况，环境
revolutionize|革命化
outweigh|超过
cast|投掷，扔
uncertain|不确定的
threat|威胁
conservative|保守的
overestimate|高估
documentary|纪录片
relieve|减轻，缓解
regardless|不管，不顾
pause|暂停，迟疑
launch|发布，推出
apartment|公寓
spark|火花
eliminate|消除
unintentionally|无意地
opposition|反对
polar|极地的
integral|必需的，不可缺少的
guard|保护
branch|分支，分公司
affiliate|使隶属于
irrigation|灌溉
stove|炉子
memorable|值得纪念的
elimination|消除，淘汰
revenue|收入
decisive|决定性的
displace|取代
violation|违反
ideological|意识形态的
neighborhood|附近
calorie|卡路里
fierce|激烈的
mention|提及
extend|延伸；延期
column|专栏
analytical|分析的
figure|数字
frighten|使害怕
preindustrial|工业化以前的
furnish|提供
scarcity|缺乏
transform|转变
misled|(mislead过去式)误导
intervene|干涉
vary|变化
bureaucracy|官僚主义
recruiter|招聘者
pattern|模式
necessity|必须，必要性
deny|否认
drift|漂流
endorsement|支持
dare|勇敢，敢于做
consultancy|咨询公司
constant|不断的
deposit|存放 n. 存款
transmit|传播，传导
undermine|削弱
resign|辞职
respective|各自的
consent|同意
reunion|团聚
premium|〔尤指每年缴付的〕保险费
interpretation|解释，理解
concrete|具体的
facility|设施
convert|转换，改变
prompt|促使
weave|织布，编织
conformity|一致
inaction|不作为
trim|修剪
irony|讽刺
monopolize|垄断
workload|工作量
complicated|复杂的
property|财产
underrepresented|未被充分代表的
philosophy|哲学
regime|制度，管理体制
bizarre|古怪的；奇怪的
ruin|毁坏
inspire|鼓励
deforestation|砍伐森林
exceptional|例外的
hazard|危险
upgrade|升级
abnormally|不正常地
accidentally|偶然地，意外地
frontier|边境
considerable|相当多的
legalize|合法化
dispensable|可有可无的
certify|保证，证明
insurer|保险公司；承保人
overstate|夸张
profound|深刻的；博学的
agony|痛苦
craft|手艺 v. 精巧地制作
obscurity|默默无闻
guarantee|保证
dolphin|海豚
severity|严重性
discourage|阻止；使气馁
fault|过失
robbery|抢劫
inanimate|无生命的
calculation|计算
baffle|使迷惑，困惑
overcharge|多收钱
nap|小睡
disposal|处理；支配
authorities|当局
chronicle|记录
shade|为…遮阳[挡光]，遮蔽〔光线〕
milestone|里程碑
unstable|不稳定的
strain|压力
municipal|市政府的
ideologically|意识形态上地
greedy|贪婪的
robust|强健的
diagnose|诊断
definite|一定的，确切的
reserved|保留意见的；矜持的
affection|喜爱
material|材料
conduct|进行，实行
association|联系
collide|撞击，碰撞
industrious|勤奋的
fascinate|使着迷
prevalence|流行，普遍
exert|施加
minor|次要的，小的
tempting|吸引人的
appropriation|挪用
injustice|不公正
irrelevant|无关的
registration|注册，登记
democracy|民主
grateful|感激的
offense|冒犯
atmosphere|气氛；大气（层）
approach|方法
rival|对手
commitment|承诺
furious|生气的；激烈的
accurate|精确的
abstract|抽象的
deprivation|剥夺，匮乏
designate|指定，委派
turtle|海龟
expertise|专业知识
vessel|血管
ventilate|使通风
trade-off|权衡，交易
endless|无限的，没完没了的
temptation|诱惑
legislation|立法
duplication|复制品
trick|骗局，诡计
evaluation|评价
abandonment|放弃
turbulent|动荡的，骚乱的
expel|开除，驱逐
carpenter|木匠
hasty|匆忙的
unprecedented|史无前例的
extreme|极端的
outperform|胜过
modernize|现代化
interactive|〔人与计算机程序、电视系统等〕交互的，互动的；合作的；相互交流的
successively|接连着地，继续地
innovation|创新，革新；新观念；新方法；新发明
elaborately|复杂地，精心设计地
vegetarian|素食主义者
faculty|〔大学的〕全体教员
render|给予
portray|描述
notion|想法，观点
tropical|热带的
character|角色；某物的特色
infectious|感染的，传染的
lawn|草坪
permanent|永久的
transcend|超越
kidnap|绑架
dominate|主导，主宰
stabilize|使稳固，使安定
consult|咨询
resume|简历
migrate|移民；迁徙
isolation|隔绝，隔离
derive|获得
conservation|保护
incidence|发生率
perpetual|永久的
pessimistic|悲观的
crew|机组人员
mourn|哀悼
vice|恶习
shot|照相，照片
virus|病毒
dorm|宿舍
erupt|爆发；喷出
impact|影响
index|指数；标志，指标
claim|声称；索取
embrace|采纳，接受
enviable|值得羡慕的
blouse|女衬衫
deliver|递送；发表演讲
rhythm|节奏
code|代号，密码
monopoly|垄断
interfere|干涉；妨碍
contestant|参赛者
ridiculous|滑稽的，可笑的
glamorous|有魅力的，迷人的
mall|商场
chronically|慢性地；持久地
prolonged|长时间的
symptom|症状
compelling|引人注目的
immensely|非常，极大地
species|物种
battle|激战，战役
conflict|冲突
permeate|渗透
erroneous|错误的
compartment|车厢, 隔间
metropolitan|大都市的
grip|抓住
crush|压碎，压榨
prior|先前的；优先的
formula|公式
inescapable|不可避免的
skeptical|怀疑的
harness|利用，控制
destination|目的地
vocational|职业的
density|密度
variance|不同
landmark|地标
linger|逗留，徘徊
luxurious|奢侈的，豪华的
astronomical|天文数字的
coordination|协调；（肌肉的）协调
currency|货币
blame|谴责
dismiss|解雇
testify|作证；证明，检验
qualify|使有资格
inquire|询问
emphasize|强调
overwhelming|压倒性的
flame|火焰
imitate|模仿
handle|把手
drought|干旱
drummer|鼓手
revive|复兴；复苏
vulnerable|脆弱的, 易受影响的
spot|点；地点，处所 v. 发现
suppress|镇压，压制
diminish|减少
reconcile|使一致；使和解，调解
artificial|人造的；虚伪的
athletic|强壮的；擅长运动的；运动的，运动员的
confrontational|对抗的，有敌意的
row|划船
navigate|航行，驾驶
panic|惊慌
hostile|有敌意的
console|安慰
endanger|使……危险
prospect|前景
discern|识别
judicial|司法的
impair|损害
motel|汽车旅馆
signal|标志
therapy|疗法
diverse|各种各样的
conserve|保留，保护
adaptation|改编版；适应
resist|抵制
convince|使……相信
burden|负担
payroll|工资总额
unified|统一的
hasten|加速
intertwine|交织，纠缠
accommodate|容纳；适应
prescribe|开处方
construction|建筑
endure|忍受
election|选举
jury|陪审团
glory|光荣，荣誉
sew|缝上，缝纫
sector|部门
hazardous|危险的
deprive|剥夺
generous|慷慨的
constrain|限制
phenomenon|现象
assume|假定，认为
conscientious|有良心的，认真负责的
concession|妥协
suspect|怀疑 n. 嫌疑犯
sample|样本，样品
penalty|惩罚
representative|代表
soothe|安慰，减轻
entail|使需要，使必须
objective|目标，目的
submit|提交
identify|认出，识别
infect|感染
burial|埋葬
genius|天才
submerge|淹没
stereotype|刻板印象，固有印象
clarify|澄清，明确
conversion|转变
resident|居民
aspect|方面
apologize|道歉
decent|像样的；正派的，规矩的
fixture|固定装置
institution|机构
scent|香味
welfare|幸福；福利
subsidy|补助
superficial|表面的
private|私人的
conventional|传统的
wonder|想知道，好奇
tedious|冗长的
subordinate|从属的；次要的
frame|制定，拟定〔计划、体制等〕
smuggle|走私
reimbursement|返还费用
disappear|消失
inhale|吸入
majority|大多数
memorize|熟记
cumulative|积累的
trap|捕捉
lofty|高耸的；崇高的
clarity|清晰，清楚
interact|互动
refine|提炼；改进，完善
confer|授予
anonymous|匿名的
commentator|评论员
keen|敏锐的；浓厚的
enforce|强迫，迫使
grocery|杂货店
spread|传播，扩散
recruit|招聘
justified|正当的
eccentric|古怪的
bridge|架桥于…之上；缩小
neglect|疏忽；忽视
principle|道德原则；原则
stain|污渍，污点
encourage|鼓励
convincing|令人信服的
indiscriminately|不加选择地，不加区分地
resolute|坚定的
indicative|指示的
perish|死亡
philosopher|哲学家
recipe|食谱；秘诀
excessive|过度的
rigor|严格，严谨
deficient|不足的，缺乏的
incompetence|无能
entitle|使具有资格
adventurer|冒险者
quicken|加快
divert|使转向；转移注意力
recommend|推荐
incalculable|不可估量的，无法计算的
outcome|结果
scaffolding|脚手架
garage|车库
domestic|国内的
cultivate|培养
formulate|制定，规划
shed|洒 (热血)
worldwide|世界范围地，全世界
fuss|小题大做
contention|争论
hijack|劫持
dweller|居住者
buck|反对 n. 美元
view|看待
pronoun|代词
contribution|贡献
undecided|不确定的
restrict|限制
reverse|相反的
grasp|理解；抓住
provoke|激怒
texture|质地
publicity|宣传
format|形式
indifferent|冷漠的
incentive|刺激
prejudice|偏见
assumption|假设
habitual|习惯的
sculpture|雕塑
responsibility|责任
manuscript|手稿
duplicate|副本，复制品
ecosystem|生态系统
humorous|幽默的
contaminate|污染，弄脏
orbit|轨道
evolve|进化
skyrocket|猛增
portion|部分
cautious|谨慎的
assassinate|刺杀，暗杀
narrow|变窄，缩小
botanical|植物学的
conquer|征服
regain|重新获得
composition|作文
stress|强调
yield|产生
spectacle|景象
host|主持
release|释放；发布
malicious|恶毒的
prevailing|流行的
gratitude|感激
mobility|流动性；活动性
ascend|上升
fake|假货
inflation|通货膨胀
plot|情节
manufacture|生产，制造
criticism|批评
outsource|外包
obstacle|阻碍
appreciative|表示赞赏的，感谢的
predominantly|占主导地位地
invasion|入侵
detect|发现
addict|吸毒上瘾者；对…着迷的人
slash|猛削，劈，砍；削减
cognitive|认知的
extinguish|熄灭；使消亡
disadvantage|缺点，不利条件
alien|陌生的
barely|几乎不，仅仅
simulate|模拟，模仿
prospective|预期的；未来的
interaction|相互影响，相互作用；互动
materialize|实现
contribute|有助于，促成；捐赠
dishonest|不诚实的
appeal|请求，呼吁,；上诉
applicant|申请者
intelligent|聪明的
spacious|宽敞的
fatal|致命的
counselor|咨询顾问
potential|潜在的 n. 潜力
assimilate|同化
cropland|农田
relieved|轻松的，缓解的
compel|强迫
program|计划，安排
capacity|能力；容量
orient|使确定方向；使适应
undertaking|任务，事情
shift|转移注意力；转变
liberation|解放
utterly|完全地，彻底地
immense|巨大的
inferior|比……差
accrue|积累
genuine|真的；由衷的
nominate|提名
distinctive|与众不同的
mismanagement|管理不当
reckon|认为，评价
mask|面具 v. 掩饰，掩盖
forge|伪造；锻造
identical|相同的
imperial|帝国的
target|目标 v. 把…作为目标
disconnect|断开
immigrant|移民
unqualified|不合格的，不胜任的
edit|编校；编辑；剪辑
govern|管理
assert|主张，断言
breezy|轻松愉快的
hesitate|犹豫
presidency|总统任期
quota|配额
dropout|辍学学生
capture|逮捕；捕捉
integrity|正直
flee|离开
certification|证书
instant|立即的
criminal|犯罪的 n. 罪犯
clue|线索
arrogant|傲慢无礼的
elevate|提升；举起
expansion|扩张；扩大
authority|权威；当局
publicize|宣传
reflective|反映的，反射的；深思熟虑的
quantity|数量
acutely|强烈地
isolate|使隔离
vigorous|积极的；精力充沛的
counsel|建议，忠告
vivid|生动的
hostility|敌意
collaborate|合作
consultation|商议
transition|过渡
deteriorate|恶化
pasture|牧场
eyewitness|目击者
trait|特点
anticipate|期望，预期
numerous|无数的
combination|组合，结合
slightly|轻微地
dividend|分红，红利
minimal|最低的，最小限度的
derail|脱轨
barrier|障碍，阻碍
ingenuity|创造力
bribe|贿赂
guesstimate|大概估计，瞎猜估计
negotiation|协商
hardship|艰难
badge|标记, 徽章
compromise|妥协
excess|过量，过度
descendant|子孙后代
fulfill|实现
collective|共同的
amend|修订
tangled|纠缠的；复杂的
qualification|资格
recall|回忆起，想起
adopt|采纳
tasteless|没有味道的
drown|溺水
tragedy|悲剧
circulation|发行量
grand|壮丽的，极好的
inadequate|不足的
household|家庭，一家人
authorization|授权
auxiliary|辅助的
adverse|不利的
descriptive|描写的，描述的
trace|追踪
bloom|开花，茂盛
evaluate|评价
humanistic|人文的
cozy|舒适的
plough|犁
melt|融化
lest|以免
ready|乐意的，愿意的
formidable|可怕的；令人敬畏的，令人惊叹的
feasible|可行的
regarding|关于
needle|指针；针
dimension|尺寸；维
specialize|专业从事
overturn|推翻
shrank|收缩(shrink过去式)
adversely|不利地
check|检查；阻止
testimony|证词
rigorous|严格的
privileged|有特权的
expectation|期望
bias|偏见
lawsuit|诉讼
eloquent|口才好的，雄辩的
shrink|缩减，缩小
regulation|规则；管理
alternative|代替品
moist|潮湿的
surpass|超过
fabric|布料
distinction|区分
eradicate|根除
brilliant|才华横溢的；极好的
redefine|重新定义
arm|装备，武装
intensely|强烈地
desperate|绝望的，不顾一切的
sexism|性别歧视
bruise|使碰伤，擦伤
prominent|卓越的；突出的
comprehensive|综合的，全面的
forecast|预报，预测
champion|支持，拥护
specification|说明
layout|布局，设计
rally|集会
romantic|爱情的
deviate|偏离
insufficient|不足的
boost|提高
scandal|丑闻
confine|限制
conspicuous|显著的
significant|重要的
fresh|新颖的，新奇的
indulge|放纵
instinctively|本能地
complement|补充
content|满意的
squalor|肮脏
fatigue|疲惫
awesome|令人敬畏的,令人赞叹的；极好的
responsive|灵敏的，反应的
echo|随声附和，发出回声
division|分歧
gender|性别
correlation|相关，关联
casualty|伤亡人数
appropriate|适当的
subtle|微妙的
critical|批评的；关键的
alternatively|二选一地；非此即彼
intimate|亲密的
disengagement|分离
lounge|休息室
gesture|姿势，手势
script|脚本，剧本
prestige|名声，声望
awkward|尴尬的；棘手的；笨拙的
entrepreneur|企业家
automatic|自动的
thrive|繁荣，兴旺
enrich|丰富，使富裕
chew|咀嚼；深思
vehicle|车辆
intriguing|有趣的
segregation|隔离
hurl|猛投
hatch|孵化
disservice|危害
variation|变化
enormous|巨大的
scare|恐吓，惊恐
alphabetical|按字母表顺序的
conclusive|得出结论的
epidemic|流行病
solid|坚实的；稳固的
clause|条款
attendant|服务人员
collapse|坍塌，崩塌
dispatch|发送，派遣
shrug|耸肩
redundant|失业的，被解雇的；过剩的
alert|机警的 v. 提醒
deficit|赤字
restructure|调整，重建
tap|轻敲
simultaneous|同步的
arise|出现
wildlife|野生动物
overwhelm|压倒，战胜
motivation|动力，积极性
delicate|细微的；精细的
remarkable|显著的，杰出的
slavery|奴隶制度
untreated|未经处理的
suspicious|怀疑的
ancient|古代的
distort|歪曲；扭曲
skip|跳过
wishful|一厢情愿的
entrepreneurship|企业管理
bride|新娘
unfold|展开
interference|干涉
assault|攻击
shareholder|股东
breakthrough|突破性进展
footnote|注脚
applicable|可应用的
controversial|受到争议的
inherit|继承
facilitate|使便利；促进
manifest|表明
fiscal|财政的
gown|长袍
rate|费用
mortality|死亡率
decline|拒绝
mournful|悲哀的；令人惋惜的
paradox|悖论
simultaneously|同步地，同时地
strategy|策略
literacy|识字， 有文化
apathy|冷漠
boom|繁荣
oblige|迫使
incompatibility|不兼容
commerce|商业
attribute|归因于
cafeteria|自助餐厅
cripple|残疾，跛子
shuttle|航天飞机
nightmare|噩梦
startle|使惊讶
debris|残骸，碎片
assemble|收集，组装
perception|看法；意识
coastal|海滨的
desert|放弃，抛弃
peer|同龄人
embody|体现
sympathetic|同情的
backup|后补，援助
notably|显著地，尤其
exploit|开发，开采
poetry|诗歌
discriminate|歧视；区别
readjust|重新调整，再调整
slight|轻微的
strip|狭长的一块
tackle|解决，处理
steady|稳定的
minority|少数，少数民族
aspirational|渴望成功的的
discipline|训练，管教
threshold|门槛
soar|高飞
uneven|不均衡的
crucial|关键的
athletics|体育运动
needy|贫穷的
enthusiastic|热情的
trigger|引发，引起
essential|必须的；本质的
agenda|议程
owe|欠钱
justice|公平
donor|捐赠者
convict|证明……有罪
underestimate|低估
flat|平的 n. 公寓
confidential|机密的
unexpected|意想不到的
vitamin|维他命
jeopardize|危害，危及
disproportionately|比例不均地，不成比例地
bacteria|细菌
achieve|达到，实现
bump|颠簸
existence|存在；生存
sweep|扫除，清除
shrewd|精明的
illuminate|阐释，阐明
realm|领域，方面
blueprint|蓝图，设计图
pension|养老金
administration|管理；政府
track|追踪 n. 轨迹，踪迹
ponder|仔细考虑
paradise|天堂
ethnic|种族的
accelerate|加速
bitter|痛苦的
ambition|野心，报复
confess|承认
extent|程度
accountant|会计
sheer|纯粹的
deliberate|故意的
pave|铺路
measure|措施
potentially|潜在地
remove|消除，移除；更新
allergic|过敏的
available|可获得的，可利用的
initial|初步的，最初的
consensus|共识，一致
opponent|反对者
modify|改变
signify|表明，象征
accumulate|积累
mining|采矿业
violent|暴力的
adversity|逆境
dynamics|动力学
chaos|混乱
persistent|持续的；坚持不懈的
ritual|仪式
criteria|标准
impose|强加于
untiring|不知疲倦的
contrary|相反的
nutritious|有营养的
anxiety|焦虑
rewarding|有意义的
straightforward|直接的
descent|血统, 后裔
hospitality|友好
stuff|材料，东西
reflect|反映；反射；思考
carpentry|木工活
decode|解码
flaw|缺点，瑕疵
reveal|揭露
tutor|辅导
accustom|使习惯
acquaintance|熟人
distribution|分布，分配
trend|趋势
irritate|激怒
intrinsic|本质的，固有的
deem|认为
arouse|唤起
suburban|郊区的
pursue|追求
ideology|意识形态
layman|门外汉
instantaneous|即时的，瞬间的
seasick|晕船的
lack|缺少
exaggerate|夸张
magnify|放大
utilization|利用
twist|扭曲
expedition|探险，远征
switch|转换
inheritance|继承；遗产
sponsor|赞助 n. 赞助商
deterioration|恶化，退化
ongoing|持续的，不间断的
refreshing|新鲜的
incidentally|顺便地，附带
imprison|监禁
present|呈现，给予
uninformed|无知的，未受过教育的
overlap|重叠
slim|苗条的
urban|城市的，都市的
rank|排列；分级
untrustworthy|不值得信任的，怀疑的
automatically|自动地；不经思考地
accountable|应负责的，有责任的
collaborative|合作的
practice|做法
diligence|勤奋
victim|受害者
urge|催促
fertility|多产，肥沃
foundation|基金会
reception|接待
elite|精英
suicide|自杀
incompetent|无能力的，不胜任的
tremendous|巨大的
recyclable|可回收利用的
visualize|想象
exertion|运用
slack|疲软的，萧条的
rigid|严格的
organic|有机的
reproduction|繁殖
strap|用带绑住
precision|精确性
standardize|标准化
aptly|适当地
promotion|促销
paralyze|瘫痪，麻痹
degeneration|退化，变质
refrain|抑制，避免
flavor|口味
adventure|冒险
agonize|使痛苦
mount|增加
oppose|反对
justifiable|理所应当的
promote|促进
renewable|可再生的
hypothesis|假设，假说
presentation|展示；讲话
cater|迎合
unbiased|公正的
immersive|沉浸的，身临其境的
domain|领域
primitive|原始的；简单的
urgent|急迫的
threaten|威胁
throne|王位
underfunded|资金不足的
jail|监狱
assessment|评估，评价
frustrate|使挫败，使沮丧
abolition|废除
detective|侦探
skyscraper|摩天大楼
corruption|腐败
intolerant|无法容忍的
pierce|刺穿
compensate|弥补
gap|差距
worship|崇拜，喜爱
gallery|美术馆
coach|教练
cancel|取消
strike|罢工
rebellion|叛逆
distract|分心，分散注意
imperative|必须的,必要的
geology|地质学
sway|影响
costume|服装
manual|手工的；体力的
quantifiable|可量化的
expenditure|费用，花销
breed|繁殖；导致
emerge|出现
noted|著名的
position|安放 n. 位置；职位
extinction|灭绝
receptionist|接待员
reckless|鲁莽的
abuse|虐待 v. 滥用
accuse|指控
biochemistry|生物化学
optimism|乐观
predict|预测
notoriously|臭名昭著地
board|董事会
pose|形成
memorandum|备忘录
puzzling|迷惑的，困扰的
reliable|可靠的
replacement|代替
reinforce|增强，强化
impart|传授，教授
diversity|多样性
occupation|职业
intense|激烈的，强烈的
dramatically|大幅度地；戏剧性地
awareness|意识
virtually|几乎
maturity|成熟
rare|罕见的，稀少的
curb|限制，控制
favor|恩惠；善意的行为
productivity|生产力
mechanism|机制
helicopter|直升飞机
validity|有效性；真实性
relevant|相关的
miracle|奇迹
fertilizer|肥料
shady|阴凉的
poll|民意测验
countermeasure|对策
worldly|世间的，尘世的
legislator|立法者
campaign|活动
odds|可能性
shepherd|引导，带领
schedule|计划表
access|取得，获取
owl|猫头鹰
interpret|口译；解释
intervention|干涉
bemoan|抱怨；惋惜
determine|决定
incur|引起，导致
literal|字面的
proposition|提议，主题
feasibility|可行
destructive|破坏性的，毁灭性的
denationalize|使非国有化
resort|度假胜地
engage|忙于，从事；雇佣
disarm|解除，消除
approximately|大约
cover|遮盖，遮蔽
validation|证实
widespread|广泛传播的
unethical|不道德的
withdraw|撤销，撤退
relay|接替，转播
fluently|流利地
mysteriously|神秘地
hinder|阻碍
session|会议；学年
postdoctoral|博士后的
prioritize|优先
bipartisan|两党的
reluctance|勉强，不情愿
intuitive|直觉的
quote|引用
pragmatic|务实的，讲求实际的
alleviate|减轻，缓解
underlying|潜在的，基础的
generate|产生
dysfunction|失常
invasive|入侵的
ignore|忽视
specific|具体的
elegant|高雅的，雅致的
capital|资金的，资本的
indicate|表明
eligible|适合的；胜任的
procedure|程序
unrealistic|不现实的
occur|发生
aggravate|加重，加剧
frankly|坦率地
thrilling|令人兴奋的
irreversible|不可逆的；不可取消的
marine|海洋的
interracial|种族间的
grave|严重的
undocumented|无证明的
appoint|任命
rhetorical|修辞的
momentum|动力，势头
deserve|值得
drastically|激烈地，猛烈地
particle|粒子，微粒
miniature|微型的
merit|值得 n. 优点
category|种类
liability|责任；债务
hack|黑客攻击
matter|重要；要紧
brutal|残酷的
biodiversity|生物多样性
subsequently|随后
bother|困扰
subconscious|下意识的，潜意识的
genetic|基因的
recurrence|再次发生
defect|缺点
retailer|零售商
memo|备忘录
chain|连锁店
executive|执行官
ballet|芭蕾
enrollment|入学人数
propose|提出
frantic|疯狂的
allegedly|据说
manipulate|操纵
coverage|报道
novel|新颖的
previous|之前的
neutrality|中立
underscore|强调
indispensable|必不可少的
puzzle|迷惑
illustrate|阐明，说明
sanitation|卫生环境，卫生设备
defensive|防守的，防御的
perspective|视角，观点
migration|迁徙，移居
float|漂浮
flexible|灵活的
capable|有能力的
practical|实践的；实用的
territory|领域，领土
urbanization|城市化
privilege|特权
forthcoming|即将来临的
widen|拓宽，变宽
deduction|扣款
virtual|虚拟的；事实上的
boast|自夸
monetary|货币的
dim|暗淡的；愚蠢的
sensible|理智的
infant|婴儿
precedent|先例
activate|激活
accomplish|实现
immigration|移民
approve|赞同
pessimist|悲观主义者
aggressive|挑衅的
toxic|有毒的
ruling|裁定
prolong|延长
tension|紧张
specialist|专家
encounter|遭遇
reap|收割，收获
institute|研究所，学会，学院
maintenance|维修
legend|传奇
groundless|无理由的，无根据的
undertake|承担；着手，开始
commodity|商品
stimulate|刺激；激励
tough|困难的，粗暴的
vital|重要的
ankle|脚踝
surgical|手术的
peculiar|奇怪的；特有的
fade|褪色
pursuit|追求
sophisticated|复杂的，精密的；老于世故的
lobbyist|游说者
lessen|减少
handgun|手枪
influential|有影响力的
detached|冷静的，超然的
biography|传记
curriculum|课程
margin|利润
fearlessly|无畏地，大胆地
randomly|随机地
discrimination|歧视
stimulus|刺激
competence|能力
sneak|溜走
exceed|超过
turbulence|气流；骚乱
address|解决
trade|做买卖；交换
deal|买卖毒品
hike|作长途徒步旅行
action|行动
resultant|作为结果而发生的
consequent|作为结果的；必然的
composer|作曲家
slave|作苦工；奴役
grunt|作呼噜声；咕哝
abide|忍受；遵守
value|尊重，重视；估价
dignity|庄重；尊严；体面
outermost|最外面的，最远的
optimum|最优的，最适宜的
initially|最初，开始
makeup|化妆品；性格；构造；组成
integral|作为组成部分的；内置的
composition|组成，构成，结构
block|阻塞；障碍物
damn|谴责
ample|足够的；宽敞的
suffice|足够
lease|租约，契约，租契
charter|包租（飞机、船等）
headquarters|总部
executive|（机构或公司的）主管，经理
main|总管道，干线
overall|总的
conceit|自负，自高自大
ultraviolet|紫外（线）的
descendant|子孙，后裔
endow|资助；赋予
datum|资料；数据；已知数
qualification|资格；学历
bourgeois|中产阶级的；庸俗的；资产阶级的
woodpecker|啄木鸟
bump|撞上
crash|（发出巨响的） 猛撞
way|（特定的）状态，状况
superb|壮丽的；超等的
ornament|装饰物
decorative|装饰的；可作装饰的
ornamental|装饰的
mount|装配
shipment|装载的货物；装货
can|装罐头
array|（美观地）排列 n. 陈列
diversion|转移；改道；娱乐
convert|转变，改变，变换
transition|转变，变迁；过渡
torque|转（力）矩，扭（力）矩
box|（法庭的）专席
workshop|专题讨论会
patent|专利的 n. 专利
clutch|抓住，掌握，攫
nest|筑巢，为…筑巢
coin|铸造（硬币）
noted|著名的，知名的
watchful|注意的，警惕的
inject|注射；注满；喷射
storage|贮藏；保管
position|形势；主张，立场
metropolitan|主要都市的 n. （东正教和天主教的）大主教
principally|主要，大抵
stalk|主茎，叶柄
preside|主持；主奏
eject|逐出，排斥；喷射
bamboo|竹；竹杆，竹棍
jewellery|珠宝，珠宝饰物
wrinkle|皱纹 vt. 使起皱纹
axial|轴的；轴向的
axis|轴，轴线
ambient|周围的，包围着的
periodic|周期的；一定时期的
anniversary|周年纪念日
peripheral|外围的的；末梢的
perimeter|周（边）；周长
anybody|重要人物
responsible|可靠的；责任重大的
consequence|重要（性），重大意义
category|种类，类目；范畴
species|种，物种；种类
hearty|热情友好的；丰盛的
neutron|中子
intermediate|中间体；调解人
proton|质子，氕核
qualitative|质的；定性的
fabricate|捏造；制作
fabrication|捏造；制作
volunteer|志愿者 v. 志愿
rebuke|指责，非难，斥责
indicative|指示的；陈述的
denote|指示，意味着
instructor|指导者，教员
designate|指定；指示；指明
colonial|殖民地的，殖民的
vocation|职业，行业
notable|值得注意的；著名的
merit|值得；应受赏（罚）
weaver|织布工，编织者
brace|支柱 v. 拉紧，撑牢
check|支票；帐单
second|支持
bearing|方位；（机器的）承座；轴承；忍受
symptom|症状；征兆，征候
regime|政权，政体；制度
politics|政纲，政见，策略
platform|政纲，党纲，宣言
confirmation|证实，确定；确认
testify|作证；证明，证实
audience|正式会见；拜会
correctly|正确地，恰当地
positive|正的，阳性的；正的，正极的，阳性的；正的，正数的
normalization|正常化，标准化
sign|征兆，迹象，病症
conqueror|征服者，胜利者
controversy|争论，辩论，争吵
suppress|镇压；抑制；禁止发表；封锁；查禁
gust|阵风，一阵狂风
clinic|诊所，医务室；会诊；会诊时间；门诊时间
diagnose|诊断（疾病）
sincerity|真诚，诚意；真实
cherish|珍爱；怀有（感情）
detective|侦探，警探；私人侦探，私家侦探
underline|着重；强调 n. 预告
grind|磨碎，碾碎，把...磨成粉
discount|折扣 v. 打折扣卖
literally|照字义，逐字地
illuminate|照明，照亮；阐明
summon|召唤；鼓起（勇气）
marsh|沼泽地，湿地
entertainment|招待，招待会
hindrance|障碍，妨碍
hose|软管；袜类（包括连裤袜、长筒袜、短袜）
sofa|长沙发，沙发
tensile|张力的；能伸长的
warfare|战争，战争状态
battle|战斗，与…作战
predominant|占优势的；主要的
unfold|展开；展现，呈现
cling|粘住；依附；坚持
viscous|粘滞的，粘性的
coherent|（文章、观点等）连贯的，有条理的，一致的
album|（收存照片或邮票的） 册子
glue|粘牢
cement|粘结
adhere|粘附；追随；坚持
strip|窄条，长带
grasshopper|蚱蜢，蝗虫，蚂蚱
wink|眨眼；使眼色
further|增进
multiplication|乘法；增加
liability|责任；债务
shipbuilding|造船（业），造船学
mint|造币厂；巨额钱财
hollow|凿空，挖空
hymn|赞美诗，圣歌；赞歌
glorify|赞美；颂扬（上帝）
fore|在（或向）船头；在（或向）飞行器头部
therein|在那里
overseas|在海外，（向）国外
ashore|在岸上，上岸
outside|在…外，向…外
brand|在…上打烙印
alongside|在…旁边
roam|在…漫步，漫游
over|在（做）…时
reproduction|再生（产）；繁殖
specification|规格；明确说明，详述
disastrous|灾难性的；悲惨的
operation|运算
freight|货运；运费
locomotive|运动的；机动
lunar|月亮的
undertake|从事；承诺
primitive|远古的，未开化的
dome|圆屋顶，拱顶
cylinder|圆筒；柱（面）；汽缸
satisfactorily|圆满地
nucleus|原子核，细胞核
prototype|原型；典型，范例
vowel|元音；元音字母
marshal|元帅；陆军元帅
subscription|订阅（费）；用户费（的缴纳）
prophet|预言家，先知
prophecy|预言；预言能力
prediction|预言，预告；预报
preset|预先装置
beforehand|预先；提前地
budget|预算；〔政府的〕
foresee|预见，预知，看穿
prevention|预防，阻止，妨碍
tulip|郁金香
intonation|语调，声调；发声
cosmic|宇宙的；广大无边的，极大的
cosmos|宇宙
overlap|与…交搭，重叠
excuse|为…辩解；使免除
senseless|愚蠢的，无意义的
amusement|乐趣；娱乐，消遣
torpedo|鱼雷，水雷
margin|余地；（获胜者在时间或票数上领先的）幅度，差额；利润；赚头
roundabout|转弯抹角的；迂回的
kidnap|诱拐，绑架
guilt|内疚；有罪，犯罪
shadowy|有影的；幽暗的
avail|有益于，有用 n. 效用
ambitious|有雄心的；热望的
significant|重要的，重大的，影响深远的
validity|（法律上的）有效；符合逻辑，正确
availability|有效（性）；可得性
finite|有限的；有尽的
magnet|有吸引力的人（或物）
profitable|有利的；有益的
advantageous|有利的，有助的
courteous|有礼貌的，谦恭的
bead|有孔小珠；水珠；露珠
commonsense|有常识的
conservative|保守的，守旧的
liable|有（法律）责任的
yacht|游艇，快艇
uranium|铀
tanker|油船；空中加油飞机
postal|邮政的，邮局的
superiority|优越（性），优势
elbow|用肘挤，挤进
paper|贴壁纸
cutter|用于切割的器械
net|用网捕；用网覆盖
head|用头顶（球）；朝...行进
tug|用力拖 n. 猛拉，拖
hook|（使）钩住，挂住
formulate|规划；制定；准备
sniff|用鼻子吸，嗅
courageous|勇敢的，无畏的
emigrate|永久移居国外
perpetual|永久的；四季开花的
everlasting|永久的；持久的
eternal|永久的；不朽的
stiffness|硬度
comply|应允，遵照，照做
bound|应当的；必定的
salute|（向…）行军礼，（向…）致敬
cater|迎合，投合
press|出版社；印刷所；印刷机
printer|印刷工；印花工
harbour|怀着（不好的想法、恐惧或希望）；包含，藏有；窝藏
diet|日常饮食，日常食物
tempt|引诱，诱惑，劝诱
cite|引证；引用；〔法院〕传召，传讯
ignite|引燃，着火
derivation|引出；起源；衍生
banker|银行家
obscure|无名的；鲜为人知的
inasmuch|因为，由于
through|因为，由于
consciousness|意识；知觉
observation|意见，短评，按语
cross|恼怒的
refrain|抑制，制止，忍住
restrain|制止；抑制
singular|异常的，奇异的
house|议院，会议厅
obligation|义务，职责，责任
formerly|以前，从前
veil|以面纱遮掩；遮盖
desert|遗弃；擅离（职守）
forsake|遗弃，抛弃；摒绝，摒弃
transmission|传播，传染
displace|移置；取代；置换
displacement|移置；免职；置换
colonist|移民；殖民地居民
instrumental|器乐的；有帮助的
wardrobe|衣柜，衣橱，藏衣室
garment|衣服；服装，衣着
islam|伊斯兰教，回教
evenly|一致地；平静地
compatible|兼容的
stitch|一针，缝线 v. 缝
troop|一群，一队，大量
concert|一齐，一致，协作
chop|一块排骨，肉块
baby|一家中年龄最小的人
episode|（人生的）一段经历；（小说的）片段，插曲
cluster|串，束，簇；群，组 v. 群聚；聚集
generalization|一般化；概括，综合
burglar|夜盗，窃贼
amateur|业余的 n. 业余爱好者
metallurgy|冶金学，冶金术
jesus|耶稣
fort|要塞，堡垒
postulate|假定，假设
prescription|药方，处方；处方药
cradle|摇篮；发源地
waver|犹豫不决；摇摆
wag|（狗） 摇摆 （尾巴）；摇晃 （手指）
oxide|氧化物
oxidize|氧化，使生锈
domestic|家养的
foster|培养；抚育，代养
balcony|阳台；楼厅，楼座
anode|阳极，正极，板极
proverb|谚语，格言，箴言
banquet|宴会，盛会，酒席
scope|（学科、活动、书籍等的）范围；（发挥能力的）机会，施展余地；眼界
cloak|掩盖，掩饰；覆盖，笼罩
sharply|严厉地，苛刻地
prolong|延长，拉长，拖延
retard|阻碍；减缓；放慢
pickle|腌制食品，泡菜
dentist|牙科医生
opium|鸦片；麻醉剂
deposit|押金
squeeze|压榨；榨取
compression|压缩，压紧，浓缩
squash|压碎 n. 果汁饮料
overwhelming|压倒的，势不可挡的
overwhelm|使（某人）感到不能自持，使不知所措；压倒，击败
velocity|迅速，快速
circulation|血液循环；（资料、货币等）流通
patrol|巡逻，巡查
cruise|巡航，巡航于…
quest|寻找，追求
cigar|雪茄烟，叶卷烟
scholarship|奖学金；学问，学识
radiant|容光焕发的；灿烂的
gorgeous|极其漂亮的，极其吸引人的；绚丽的，华丽的
option|选择，取舍
cock|公鸡
melody|旋律，曲调；歌曲
overhang|悬于…之上，悬垂
console|悬臂，肘托；控制台
propaganda|宣传
declaration|宣布，宣言
narration|叙述；故事；叙述法
sequence|序列，顺序
warrant|（法院授权警方采取行动的）令状；许可证
requisite|需要的，必要的 n. 必需品
embroidery|绣花，刺绣；绣制品
nun|修女，尼姑
eloquence|雄辩；口才，修辞
wind|风
directory|姓名地址录
pacific|性情温和的
survival|幸存；残存；幸存者
flush|脸红；一阵强烈情感；（流露出的）一阵激情
formal|正规的；庄重的
constituent|构成的 n. 选民
scarlet|猩红色 adj. 猩红的
religion|宗教
novelty|新颖；新奇的事物
regenerative|回授的；再生的
bridegroom|新郎
novel|新的，异常的
zinc|锌 v. 在…上镀锌
appreciation|欣赏；感激
psychology|心理学；心理
crab|蟹；蟹肉 v. 捕蟹
subscript|写在下方的 n. 下标
sideways|斜向一边地
jean|斜纹布；牛仔裤
gradient|斜坡
vicious|邪恶的；恶性的
evil|邪恶，罪恶；祸害
collaborate|协作，合作；协调
team|协作，合作
coefficient|协同因素；系数，率
wedge|楔 v. 楔入；挤入
calibration|校准；标定，刻度
paragraph|（文章的）段，段落
cautious|小心的，谨慎的
caution|小心 v. 告诫，警告
suitcase|手提箱，衣箱
decimal|小数的，十进制的
footpath|小路，人行道
puppy|小狗；幼小的动物
closet|小房间；壁碗橱
pamphlet|小册子
slack|萧条的；懈怠的
disappearance|消失，消散；失踪
recreation|消遣，娱乐活动
consumer|消费者，用户
consumption|消费（量）
depression|消沉；不景气萧条期
token|辅币；象征
ivory|象牙（质）；乳白色
forward|向前；向将来 v. 转递
southwards|向南方
orientation|定位；方向
defy|向…挑战；蔑视
hail|向…欢呼，招呼
yearn|渴望，向往
spice|香料，调味品
pilgrim|香客，朝圣者
fragrant|香的，芬芳的
incense|香，熏香；香气
uniformly|相同地；一贯
resemblance|相似，相似性
analogy|相似，类似；比拟
interact|相互作用
correlation|相互关系
reciprocal|相互的；互利的
coincide|相巧合；相符合
inversely|相反地
devotion|献身，热诚，专心
linear|线的；长度的
qualify|限制，限定，修饰
realistic|现实的；现实主义的
striking|显著的，惊人的
microscopic|显微镜的；微观的，极小的
apparent|显然的
distinctly|显然，清楚地
bacon|咸猪肉，熏猪肉
gossip|闲谈；碎嘴子；漫笔
ramble|闲逛，漫步；漫谈，闲聊
precede|先于…，领先
priority|先，前；优先，重点
shower|下阵雨，使湿透
decline|下倾；偏斜；衰退
descent|下降；出身；斜坡
subordinate|下级的，辅助的
inferior|下级；晚辈；次品
slim|细长的；微小的
taper|细小的蜡烛；微光
petty|细小的；器量小的
nice|细微的，微妙的
filament|细丝；长丝；灯丝
bacterium|细菌
germ|细菌，病原菌；幼芽
systematically|系统地，有规则地
spectrum|系列，范围；波谱
lace|系带，用带子束紧
tape|系，捆
drama|戏剧性事件；戏剧性
theatre|剧场，戏院
comedy|喜剧；喜剧场面
assault|袭击 n. 攻击
usage|习惯用法
quench|熄灭，扑灭；压制
extinguish|熄灭，扑灭；消灭
absorption|吸收；专注
intake|吸入；输入能量
physically|身体上；体格上
substantial|大而坚固的
body|物体
luncheon|午宴，午餐，便宴
ignorance|无知，无学，愚昧
insignificant|无意义的；低微的
doubtless|无疑地；很可能
indefinite|无限期的
infinitely|无限地，无边地
unlimited|无限的；不定的
infinite|无限；无穷（大）
fearless|无畏的，大胆的
innumerable|无数的，数不清的
inorganic|无生物的；无机的
ruthless|无情的，冷酷的
incapable|无能力的；无资格的
unique|无可匹敌的；极好的
faultless|无过失的；无缺点的
foreign|外国的，国外的
nought|无，零
filth|污秽，污物；淫猥；淫猥
snail|蜗牛；行动缓慢的人
hum|嗡嗡声 v. 哼曲子
compliment|致意，问候 v. 赞美，祝贺
question|问，询问，讯问
literal|文字（上）的；字面的
illiterate|文盲的 n. 文盲
stationery|信笺，信纸；文具
plague|瘟疫；鼠疫（尤指腺鼠疫）
softness|温和，柔和；软弱
graze|喂草；放牧（牲畜）
locality|位置，地点，发生地
situated|位于…的
bachelor|未婚男子；学士
unpaid|未付的；无偿的
stern|艉，船尾；臀部
commission|委托，委任；委托状
latitude|纬度；黄纬
vitamin|维生素，维他命
venus|维纳斯；美人
idealism|唯心主义；理想主义
mast|桅杆
enclosure|围场，围栏；围绕
violation|违犯；侵犯，妨碍
violate|违犯，违背；侵犯
towards|用于，有助于
plead|为…辩护，抗辩
catalogue|为…编目录
microprocessor|微信息处理机
subtle|微妙的；精巧的
atom|原子
calculus|微积分；结石
gleam|微光 v. 发微光
negligible|微不足道的
microwave|微波
awful|威严的；令人崇敬的
majesty|雄伟，威严，庄严；陛下
prestige|威望，威信，声望
endanger|危及，危害
crisis|危机；转折点
peril|危机；危险的事物
dismiss|解雇，开除
fro|往，去，回，向后
mesh|网眼，筛孔，网络
network|网络；广播网
web|网，网状物
stubborn|顽固的；顽强的
trifle|玩忽；闲混；嬉耍
completion|完成，结束，完满
crooked|弯的，歪的；畸形的
hull|外壳，豆荚；薄膜
diplomatic|外交的；有策略的
alien|外国的 n. 外国人
strange|陌生的，不熟悉的
distort|歪曲，曲解；扭曲
twist|歪曲，曲解
tile|瓷砖；贴砖；瓦片
watt|瓦（特）
elliptical|椭圆的；省略的
haul|拖曳；拖运
hip|臀部，髋
devour|吞食；吞灭，毁灭
retirement|退休，引退；退隐
drawback|妨碍；弊端
inference|推论；推断的结果
rational|合理的；适度的
propulsion|推进，推进力
propel|推进，推动
recommendation|推荐，介绍；建议
overthrow|推翻 n. 推翻，瓦解
impulse|冲动；推动
presumably|推测起来，大概
gather|推测，推断
shove|推，（使劲）推
solidarity|团结；休戚相关
regiment|团，军团；一大群
bandit|土匪，盗匪，歹徒
lever|途径，工具，手段
overtake|突然发生；压倒
nose|突出部分（如船头等）
bald|秃头的；无毛的
projector|投影仪；探照灯
poll|投票 v. 对…进行民意测验（调查）
dizzy|头晕眼花的，眩晕的
steal|偷偷地做，窃取
misery|痛苦，悲惨，不幸
torment|痛苦 v. 折磨
thrash|痛打，鞭打，打
dominant|统治的 n. 主因
dominate|统治，支配，控制
statistics|统计，统计数字
even|平稳的，均匀的
identical|同一的；恒等的
likeness|同样；类似，相似
simultaneous|同时的，同时存在的
accessory|同谋，帮凶 adj. 附属的
homogeneous|同类的
coordinate|同等的
whilst|同时；然而
notify|通知，告知；报告
advertise|登广告
correspondence|通信；相关；相似
popularity|通俗性；普及，流行
inflation|通货膨胀，物价飞涨
currency|通货；货币
entry|入口，通道；条目
customary|通常的；照惯例的
ordinarily|通常，大概
hydrocarbon|烃，碳氢化合物
resignation|听从，屈从，顺从
blacksmith|铁匠，锻工
ferrous|铁的；亚铁的
adjoin|贴近，毗连；靠近
hop|（人）单足跳
skip|蹦跳着走；跳绳；略过
overlook|眺望；看漏；宽容
regulate|调整，调节，校准
modulate|调整，调节（声音）
settlement|调停；（尤指拓荒者居住的）定居点，村落
mischief|调皮，捣蛋，胡闹
accord|符合；协议
questionnaire|调查表，征求意见表
sweetness|甜蜜，芬芳；愉悦，美好
dessert|甜点心
catholic|天主教的 n. 天主教徒
astronomy|天文学
embody|体现；包含，收录
theme|题目；主题；主旋律；（句子的）主位；词干
nominate|提名，推荐；任命
finance|提供资金
nourish|提供养分，养育
enhance|提高，增加；改进
elevate|提拔；抬高
purify|提纯，精炼（金属）
raise|提出，发起，发出
introduce|提出（议案等）
peculiarity|特性，独特性；怪癖
individual|特殊的
essential|极其重要的；必不可少的
bore|讨厌的人；麻烦事
earthenware|陶器
flee|逃走，逃避
outlaw|逃犯，歹徒
wade|趟（河），跋涉
probe|探针 v. 用探针探查
expedition|探险；探险队
charcoal|炭，木炭；生物炭
plain|坦白的；普通的
negotiate|谈判，交涉，议定
greed|贪心，贪婪
moss|苔藓，地衣
pedal|（自行车的）踏脚，踏板，脚蹬；（汽车或机器的）踏板
thereof|它的，其；由此
trivial|琐碎的；平常的
detail|琐碎，小事
concern|所关切的事；商行
what|所…的
miniature|缩影 adj. 缩小的
hurt|（对感情造成的）伤害，创伤
deform|损坏…的形状
deformation|损坏；变形；畸形
fringe|穗，毛边；边缘
scrap|碎片；废料 v. 废弃
random|随机 adj. 随机的
garlic|蒜，大蒜
plastic|塑料的；塑性的
shorthand|速记，速记法
scout|搜索，侦察
laundry|送洗衣店去洗的东西
replace|把...放回原处
loosely|松松地，松散地
rear|饲养，培植；抚养
perish|死亡，夭折；枯萎
hiss|嘶嘶声 v. 嘶嘶作声
rip|撕，扯破，划破
speculate|猜测，推测；投机
smuggle|私运，走私
confidence|私房话，秘密，机密
velvet|丝绒制的；柔软光滑的
treasurer|司库，财务主管
exposition|说明，解释；展览会，博览会
preach|说教，布道；鼓吹
observe|说，评述，评论
momentary|瞬息间的，片刻的
instantaneous|瞬间的，即刻的
couch|睡椅，长沙发椅
slumber|睡眠；沉睡状态
buffalo|水牛；水陆坦克
hydraulic|水力的；水力学的
watery|充满水的；与水有关的；湿的；（食物、饮料等）味淡的
rinse|冲洗；嗽（口）
wrestle|摔交；斗争，搏斗
numerical|数字的，数值的
reckon|计算；认为
harp|竖琴；天琴座
erect|直立的
terminology|术语学，术语
proficient|熟练的，精通的
proficiency|熟练，精通
input|输入 n. 输入
grant|拨款
dependant|受赡养者
miser|守财奴，吝啬鬼
trolley|手推车；有轨电车
manuscript|手稿，底稿，原稿
handbook|手册，便览，指南
adoption|收养；采纳，采取
revenue|收入；收入数目
oath|誓言，誓约，宣誓
vow|誓言，誓约，许愿
pledge|誓言 v. 使发誓
indoor|室内的；室内进行的
wholesome|对健康有益的
moderately|适度地，适中
fitting|适当的 n. 配件
fitness|适当，恰当；健康
vision|视力；眼力，想象力
attendant|侍者；（要人的）侍从；（病人的）护理人员
occurrence|发生的事
snob|势利小人
snobbish|势利的，谄上欺下的
influence|势力，权势
municipal|市的，市立的
conform|使遵守；一致
automate|使自动化
divert|使转向；转移
specialize|使专门化，专业化
hazard|使遭危险 n. 危险
standardize|使与标准比较
lengthen|使延长，变长
shame|使羞愧；玷辱
freshen|使显得新鲜
distinguish|使显出特色，使杰出
evaporate|使脱水，发散蒸气
ventilate|使通风，使换气
moor|使停泊；使固定
resign|使顺从，使听任于
perfect|使熟练，使改善
infect|使受影响
lubricate|使润滑，加润滑油
soften|使软化，变温和
facilitate|使容易；助长
acquaint|使认识，使了解
tiresome|使人厌倦的，讨厌的
sorrowful|使人伤心的；悲伤的
blaze|使燃烧，燃烧
subdue|使屈服，征服
bend|使屈从，屈从
suit|使配合，彼此协调
confront|使面对；使对证
paralyse|使麻痹，使瘫痪
deafen|使聋
subject|使隶属
terrify|使恐怖，使惊吓
insulate|使绝缘，使绝热
integrate|使结合，使并入
alternate|使交替 adj. 交替的
degrade|使降低；使堕落
minimize|使减到最小
mingle|使混合，混合起来
interconnect|使互相联系
reconcile|使和好；调停
oblige|使感激；施恩惠于
enrich|使富裕；使丰富
embarrass|使…陷入困境
decay|使腐朽，使腐烂
contrast|使对比；形成对比
baffle|使挫折 n. 迷惑
mature|使成熟，成熟
ice|使成冰，结冰
overload|使超载
tangle|使缠结，使纠缠
sweeten|使变甜，变甜
thicken|使变厚（或粗、密）
establish|使…被接受
develop|使（底片）显影
jog|慢跑（尤作为锻炼）
engage|使（齿轮等）啮合
vector|矢量；飞机航线
nourishment|食物；营养（情况）
pantry|食品柜，餐具室
experimentally|实验上，实验性地
experimentation|实验；试验
virtual|实际上的，实质上的
execution|实行，执行；处死刑
quartz|石英
graphite|石墨，石墨电极
whitewash|石灰水 v. 粉饰
limestone|石灰石
humidity|湿气；湿度
handout|施舍物，救济品
verse|诗，韵文；诗节
unemployment|失业；失业人数
disgrace|失宠，耻辱，丢脸
residual|剩余的；残余的
remainder|剩余（物）；余数
excel|胜过，杰出
stiff|生硬的
ecology|生态学；个体生态学
hide|生皮，兽皮，皮革
vital|生命的，生机的
producer|生产者；舞台监督
productivity|生产率；多产
productive|生产的；出产…的
hoist|升起，扯起来
kidney|肾，腰子
deliberately|故意地；审慎地
censor|审查，检查
mystery|神秘小说，侦探小说
shrine|神殿，神龛，圣祠
divine|神的；敬神的
deliberate|深思熟虑的；审慎的
profound|见解深刻的；渊博的
trench|深沟；壕沟，战壕
photography|摄影术
editorial|社论，期刊的社论
sociology|社会学
conceive|设想，以为；怀孕
reject|舍弃，抛弃；排斥
serpent|蛇（尤指大蛇或毒蛇）
extravagant|奢侈的；过度的
maid|少女；处女
maiden|少女，未婚女子
scorch|烧焦；枯萎
context|上下文；来龙去脉
heaven|上帝，神
counsel|商议；忠告；律师
tradesman|商人，店主；手艺人
trader|商人
dealer|商人；毒品贩；发牌者
ware|物品；商品，货物
merchandise|商品，货物
blue|伤心的；下流的
goodness|善良，善行，美德
underwear|衫衣，内衣，贴身衣
cancel|取消
gap|差距；山口，山峡
sift|筛，过滤
shark|鲨鱼；诈骗钱财者
gravel|砂跞；砂砾层；结石
sardine|沙丁鱼
tone|色调，光度
scan|扫描
uproar|骚动，扰乱；喧嚣
prose|散文
emission|散发；传播；发出物
stroll|散步，溜达，闲逛
triangular|三角的；三者间的
mute|弱音器
choice|入选者 adj. 优等的
tolerant|容忍的；有耐力的
commodity|日用品，商品，物品
routine|日常的 n. 常规
undertaking|任务，事业；承诺
deem|认为，相信，想
awake|认识到
recognition|认出，识别
identification|身份证；认出，鉴定
merciful|仁慈的，宽大的
hostage|人质
pitch|沥青
personnel|人事部门
humanity|人类；人性，人情
personality|人格，个性；名人
thermal|热的；温热的
tropic|回归线；热带地区
tropical|热带的；（天气）湿热的
concession|让步，迁就
combustion|燃烧
whisker|髯，连鬓胡子
flock|群集，聚集
conviction|确信，信服，深信
certainty|确实性，确信，确实
positively|确定的，断然
quantify|确定…的数量
deficient|缺乏的；欠缺的
deficiency|缺乏；不足
scarcity|缺乏，不足
flaw|缺点，瑕疵
induce|劝诱；引起
persuasion|劝说，说服
claim|权利，所有权
late|去世不久的
extract|取出；提取 n. 摘录
crank|曲柄 v. 用曲柄转动
expel|开除；驱逐；排出
dissipate|驱散；消散；浪费
spherical|球形的，球面的
global|全球的
jupiter|木星；丘庇特
plea|请愿，请求，恳求
petition|请愿 v. 向…请愿
sight|景象；名胜，风景
mistress|情妇，情人
mosque|清真寺
cleanliness|清洁
inclination|倾斜，点头；斜坡
rap|轻敲击声 v. 敲击
rash|轻率的；鲁莽的
bronze|青铜色
industrious|勤劳的，勤奋的
admiration|钦佩；赞美，羡慕
agreeable|惬意的；同意的
section|部分
segment|切片，部分；段，节
slit|切开 n. 狭长的切口
hardy|强壮的，耐劳的
compulsory|强迫的，义务的
constraint|限制，束缚，约束
mighty|强大的；巨大的
thoughtless|欠考虑的；自私的
denounce|谴责，声讨；告发
pious|虔诚的；虔奉宗教的
lobby|前厅，（剧院的）门廊
consistent|前后一致的，连贯的
predecessor|前辈，前任者
visa|签证
modesty|谦逊；端庄
gracious|谦和的
migrate|迁移，移居
kilowatt|千瓦（特）
pertinent|恰当的；有关的
apt|恰当的；聪明的
utensil|器皿，用具
maple|槭树，枫树
follower|信徒，追随者
siren|汽笛，警报器
motel|汽车游客旅馆
garage|汽车修理站
motorway|汽车道，快车路
hitherto|迄今，到目前为止
barometer|气压计，睛雨表
pant|气喘
jack|起重器；传动装置
scratch|（某人皮肤上的）划痕，划伤
count|起拆理由，罪状
message|启示，要旨，教训
enlighten|启发，开导；启蒙
implore|乞求，恳求，哀求
knight|骑士，武士；爵士
marvel|奇迹；惊奇 v. 惊奇
subsequently|其后，其次，接着
cheat|欺诈；骗取
periodical|期刊，杂志
currently|当前
universally|普遍地，一般地
bushel|蒲式耳（容量单位）
raisin|葡萄干
fracture|破裂；裂痕 v. 破裂
destructive|破坏（性）的，危害的
bankrupt|破产的 v. 使破产
persecute|迫害，残害
incline|坡度
flask|瓶
tack|平头钉 v. 钉住
terrace|平台，阳台，露台
civilian|平民 adj. 平民的
tranquil|平静的；稳定的
equation|平衡；反应式
equilibrium|平衡，均衡；均衡论
commonplace|平凡的 n. 平常话
frequency|频繁，屡次；频率
barren|贫瘠的；不孕的
float|漂浮物；浮标，木筏
bleach|漂白，变白
flake|片，薄片
deflection|偏斜，歪斜；偏差
prejudice|偏见，成见；损害
adjacent|毗连的；紧接着的
cape|披肩，斗篷；海角
clash|冲突，抵触；碰撞声
collide|碰撞；冲突，抵触
ingredient|配料，成分
shell|炮弹，猎枪子弹
battery|炮组，排炮
foam|泡沫塑料；泡沫
bypass|旁通管 v. 绕过
limp|蹒跚，跛行 n. 跛行
stagger|蹒跚，使摇晃
ascend|攀登，登高
dispatch|派遣；调度 n. 急件
faction|派别，宗派，小集团
hover|徘徊；傍徨；翱翔；盘旋
drainage|排水；下水道
range|排列
clap|拍手喝采声；霹雳声
reptile|爬行动物
overhear|偶然听到；偷听
ohm|欧姆
hostess|女主人；旅馆女老板
feminine|女性的；女子气的
waitress|女侍者，女服务员
goddess|女神
blouse|女衬衫；罩衫
coward|懦怯的，胆小的
radiator|暖气片；散热器
strive|努力，奋斗，力求
mess|弄脏，弄乱，搞糟
distortion|歪曲；畸变
shorten|弄短，缩小，减少
saturn|土星
milky|牛奶的；乳白色的
wrench|拧，扭伤 n. 拧
wring|拧，挤，扭，榨
peer|凝视
nickel|镍；镍币
junior|年少者；晚辈
annually|年年，每年
practicable|能实行的；适用的
capability|能力，才能
basin|内海；盆地；流域
interior|内部 adj. 内部的
tickle|挠，胳肢；逗乐
incredible|难以置信的，惊人的
difficult|难以满足的
refugee|难民，流亡者
pumpkin|南瓜
polar|南（北）极的；极性的
masculine|男性的
baron|男爵；贵族；巨商
endurance|耐久力，持久力
sodium|钠
pasture|牧场
intent|目不转睛的，热切的
end|目标，目的
oyster|牡蛎
magician|魔法师；变戏法的人
skyscraper|摩天楼
module|模块；组件
ambiguous|模棱两可的；分歧的
feel|摸起来
destiny|命运，天数
doom|厄运，毁灭 v. 注定
proposition|命题，主题；提议
bid|报价；命令
destine|命定，注定；预定
sensible|明显的，感觉得到的
explicit|明晰的；直率的
decidedly|明确地，坚决地
formulation|表述方式
brightness|明亮，辉煌，聪明
classic|名著 adj. 不朽的
promptly|敏捷地，迅速地
sensitivity|敏感（性）；灵敏性
representation|描写；陈述；代表
nursery|苗圃
deposition|免职，罢免
confidential|秘密的；亲信的
enchant|迷住；用魔法迷惑
fascinate|迷住，迷人
superstition|迷信，迷信行为
stray|迷路 adj. 迷路的
perplex|迷惑，困惑，难住
bewilder|迷惑，把…弄糊涂
snap|猛咬；突然折断
hurl|猛投；猛冲
jerk|猛地一拉，急拉
ally|盟国；同盟者，伙伴
threshold|门槛；入门，开端
charm|魅力；妩媚 v. 迷人
fair|美丽的
offensive|冒犯的；进攻的
pore|毛孔，气孔，细孔
fuss|大惊小怪 v. 忙乱
cartoon|动画片；漫画
vine|蔓，藤，藤本植物
expire|满期，到期；断气
bull|买空的证券投机商
wharf|码头，停泊所
circus|马戏；马戏团
filter|滤过
ass|傻瓜，蠢笨的人；驴
propeller|螺旋桨，推进器
spiral|螺旋（形）的，盘旋的
nut|螺帽，螺母
roman|古罗马人；罗马人
thesis|论文；论题，论点
forum|论坛，讨论会
oval|卵形的 n. 卵形
video|录像的
reed|芦笛，牧笛
leakage|漏，泄漏；漏出物
hug|搂 n. 紧紧拥抱
stairway|楼梯
monopoly|垄断；独占，专利
bridle|马笼头；马勒 v. 束缚；抑制
willow|柳树，柳木
streamline|流线；流线型
rascal|流氓，恶棍，无赖
prevalent|流行的；盛行的
exile|流放 n. 被流放者
flux|流；涨潮；流量
track|留下足迹
gramophone|留声机
otherwise|另外；在其他方面
province|领域，范围，职权
consul|领事
retail|零售
flexible|灵活的，可变通的
inspiration|灵感；妙想；鼓舞
grove|林子，小树林，园林
neighbouring|邻近的，接壤的
vicinity|邻近；附近地区
fission|裂开；分裂生殖
prey|猎物 v. 捕获
martyr|烈士，殉难者
grin|咧着嘴笑
expect|料想，认为
quantitative|量的；定量的
blush|脸红，害臊 n. 脸红
allied|联合的；联姻的
ripple|涟漪，细浪，波纹
mitten|连指手套
attachment|爱慕；附件；连接物
junction|连接点，汇合处
chestnut|栗子；栗树；栗色
exceptional|优越的；例外的
solar|利用太阳光的
impose|将（想法、信仰等）强加于（某人）
utilization|利用，效用
stereo|立体声 adj. 立体声的
cubic|立方体的；立方的
legislation|立法；法规
historian|历史学家；编史家
historic|历史的；历史性的
mechanics|力学，机械学
intellect|理智，智力，才智
ideally|理想地；理论上
abstract|理论上的 n. 抽象派作品
slang|俚语；行话，黑话
courtesy|礼貌，谦恭
twilight|黄昏
ion|离子
excursion|（尤指集体）远足，短途旅行
grim|严厉的
prism|棱镜；棱柱（体）
troublesome|困难的
analogue|类似物
similarity|类似，相似；类似点
flank|肋，肋腹；侧面
comprehend|了解，理解，领会
optimism|乐观，乐观主义
sophisticated|老于世故的；高级的
straightforward|老实的，坦率的
wasteful|浪费的
idleness|懒惰；赋闲无事
shabby|破旧的；褴褛的
dust|灰尘
flight|溃退，逃跑
rapture|狂喜，欢天喜地
fury|狂怒，暴怒；猛烈
violent|狂暴的
furious|狂暴的；强烈的
satisfaction|满足，愉快
snack|快餐，小吃
rapidity|快，迅速；陡，险峻
parade|夸耀（才能等）
pants|裤子；男用短衬裤
bitterness|苦味，辛酸，苦难
wither|枯萎；使衰弱
clasp|扣住，扣紧，钩住
fastener|扣件，钮扣，揿钮
stammer|口吃地说 n. 口吃
panic|恐慌，惊慌
terrorist|恐怖分子
peacock|孔雀
fantastic|空想的；奇异的
pneumatic|空气的；气动的
aerial|空气的；航空的
spatial|空间的，占据空间的
void|无效的；空的
gnaw|啃，咬断，啮
longing|渴望 adj. 显示渴望的
suspicious|可疑的；猜疑的
shady|可疑的，靠不住的
questionable|可疑的，不可靠的
portable|可移动的
grateful|感谢的，感激的
adjustable|可调整的，可校准的
frightful|可怕的；讨厌的
formidable|可怕的；难对付的
dreadful|可怕的；令人畏惧的
monstrous|极大的；可怕的
possibility|可能的事
likelihood|可能（性）
respectable|可敬的；人格高尚的
appreciable|可察觉的
shameful|可耻的；不道德的
comparable|可比较的；类似的
particular|特称的；苛求的
whereby|靠什么；靠那个
ponder|考虑，沉思
exploration|考察；勘探；探查
generosity|慷慨，宽宏大量
discern|弄清楚，辨别；看出，辨出
fell|砍倒（树等）；砍伐
carry|刊登
inaugurate|使就职；开始
initiate|开始，创始；启蒙
commence|开始；获得学位
reclaim|开垦，开拓；回收
evolution|进化
start|开动，着手；开设
unlock|开…的锁；开启
sheriff|郡长
monarch|君主，最高统治者
sovereign|君主 adj. 统治的
bugle|军号，喇叭
extinct|绝种的
decisive|决定性的；果断的
govern|决定，支配；控制
winding|蜿蜒曲折的路径 adj. 蜿蜒曲折的
curly|卷曲的；有卷毛的
reel|卷，绕
mob|团团围住（名人等）
polymer|聚合物，多聚物
hurricane|飓风，十二级风
sting|剧痛；刺痛 v. 刺
repel|使厌恶；拒绝
gigantic|巨大的；巨人似的
uphold|维护
exemplify|举例证明（解释）
rectangle|矩形，长方形
administration|局（或署、处等）
reside|居住，驻扎；属于
dwell|居住；凝思，细想
induction|就职；归纳推理
christ|救世主（耶稣基督）
symposium|座谈会
whoever|究竟是谁
rectify|纠正；调整
vein|静脉，血管；矿脉
competitor|竞争者，敌手
competitive|竞争的，比赛的
contend|竞争；坚决主张
alert|警惕的
warning|警告，告诫，鉴诫
whale|鲸
selection|选择；精选的东西
thorough|精心的；详尽的
finely|精细地；美好地
literary|文学的
refinery|精炼厂，提炼厂
vigorous|精力旺盛的，茁壮的
fright|惊吓，恐怖
astonishment|惊奇，惊讶
dismay|惊慌，沮丧，灰心
empirical|经验主义的
longitude|经线，经度
support|经受，承受
economics|经济学；经济
prohibition|禁止；禁令，禁律
shortcut|近路；捷径
inlet|水湾；进口
perfection|尽善尽美；无比精确
notwithstanding|尽管，虽然
prudent|谨慎的；精明的
compact|紧密的 v. 使紧凑
tightly|紧地，牢固地
barely|勉强；仅仅
metallic|金属的
tuna|金枪鱼
henceforth|今后，从今以后
mustard|芥子，芥末
presentation|介绍；呈现
interpret|口译；解释
version|解释
untie|解开，松开；解放
tackle|解决，对付 n. 用具
dissolve|解除（婚约等）
tuberculosis|结核病，肺结核
incorporate|结合，合并，收编
construction|建筑结构
economically|在经济上；节约地
abbreviation|节略，缩写，缩短
thrifty|节俭的
interview|接见，会见，会谈
receiver|接待者；收受者
yeast|酵母
doctrine|教义，主义；学说
tutor|教，指导
disillusion|觉醒，使觉醒
horn|角状物；喇叭形物
reef|礁，礁石，暗礁
coke|焦炭
symphony|交响乐；交响乐团
intercourse|交际，往来，交流
soy|大豆，黄豆；酱油
parachute|降落伞
degradation|降级；退化；衰变
oar|桨
discourse|讲话，演说，讲道
ginger|姜，生姜
splash|溅泼；泼水 n. 溅泼声
architect|建筑师；创造者
theory|（未证明的）见解，看法，推测
clip|剪；剪辑报刊
diminish|减少，减小
lessen|减少，变少
inspector|检查员；巡官
reserve|缄默，自我克制
challenge|艰巨任务
enterprise|艰巨的事业；事业心
resolute|坚决的，果敢的
firmness|坚固，坚定，稳固
sturdy|牢固的；坚定的
steady|稳定的，扎实的
stability|稳定
insistent|坚持的
persistence|坚持；持续，存留
persevere|坚持，不屈不挠
shrill|尖声的 v. 尖声地叫
bridge|架桥于，用桥连接
rate|价格 v. 对…评定
hypothesis|假设；前提
sham|假冒；膺品 v. 假装
fake|假货，膺品 adj. 假的
presume|假定，假设，揣测
beetle|甲虫
clamp|夹住，夹紧 n. 夹子
sandwich|夹入，挤进
homely|家常的
fowl|家禽；禽肉
poultry|家禽
heater|加热器
deepen|（使色泽等）加浓
heighten|加高，提高；增加
line|加衬里于
stillness|寂静，无声
lodging|寄宿，住宿；住所
successor|继承人，继任者
succession|继承（权）
quarterly|adj&adv. 季度的（地）
craft|技巧
souvenir|纪念品
documentary|纪录的；文献的
marginal|边缘的；记在页边的
terminal|计算机终端；线接头
scheme|计划，搞阴谋
geometrical|几何学的
bazaar|集市，廉价商店
gathering|集会，聚会，聚集
set|集（合）
disorder|疾病，小病
complaint|疾病，病痛
forthcoming|即将到来的；现成的
polarity|（人、意见或观念的）截然相反，截然对立；极性
extreme|极端不同的性质
guitar|吉他，六弦琴
timely|及时的；适时的
irritate|激怒；引起不愉快
drastic|激烈的；严厉的
severe|艰难的；简朴的
christian|基督教的
elemental|基本的；自然力的
radical|基本的；激进的
ultimate|首要的；基本的
energetic|积极的；精力旺盛的
muscular|肌肉发达的，强健的
witty|机智的；风趣的
mechanism|机械装置；机制
tact|机敏，圆滑，得体
ingenious|精巧制成的；机灵的
ingenuity|机灵；设计新颖
framework|体制
fence|击剑（术），击剑
stall|货摊，书摊；马厩
fellowship|伙伴关系；联谊会
mars|火星
ham|火腿
piston|活塞
vigour|活力，精力；元气
cloudy|混浊的；模糊不清的
mixer|搅拌器
engagement|婚约；约会
bribe|贿赂 v. 向…行贿
corrupt|使腐化 adj. 腐败的
response|回应
badge|徽章，像章；标志
wield|挥（剑）；行使
locust|蝗虫
wasp|黄蜂
royalty|皇家，王族，皇族
desolate|荒芜的；孤独的
illusion|幻想；错觉；假象
modification|修改
environmental|环境的，环境产生的
pregnant|怀孕的；意义深长的；意义深长的
fossil|化石
glider|滑翔机；滑翔导弹
pulley|滑轮，滑车，皮带轮
slide|滑动，滑行
granite|花岗岩，花岗石
correlate|互相关联的事物
walnut|核桃；胡桃树
arc|弧，弓形物；弧光
exclamation|呼喊，惊叫；感叹
outcome|后果，成果
ruby|红宝石
hit|轰动一时的人（或事）
traverse|横越
transverse|横的
bed|河床，（湖）底
harmonious|和谐的，协调的
monk|和尚，僧侣，修道士
cooperative|合作的 n. 合作社
hinge|合页，折叶，铰链
proper|合乎体统的，正派的
composite|合成的 n. 合成物
synthesis|综合，综合物；（化学或生物学物质的）合成；（用电子方式对声音、语音或音乐的）合成
applause|喝彩；夸奖，称赞
applaud|鼓掌；喝彩
hurrah|好哇，万岁，乌拉
pal|好朋友；同谋
hospitality|好客，殷勤
romantic|好幻想的
howl|嚎叫；哀号；吠
aerospace|航空航天工业
log|航海日志；飞行日志
pedestrian|行人，步行者
move|行动，步骤
hesitate|犹豫；迟疑不决
pest|害虫
strait|海峡
turtle|海龟，玳瑁
custom|海关
seaport|海港，港口，港市
cable|电缆
pirate|海盗
seaside|海滨（胜地）；海边
surplus|过剩，剩余（物资）
overestimate|过高估计
excessively|过分，极端地
excess|过度行为，暴行
orchard|果园
peel|果皮，蔬菜皮
stone|果核，（水果的）硬核
slap|掴 n. 巴掌
inland|国内的；内地的
boiler|锅炉
roller|滚筒；滚柱
valuable|贵重物品，财宝
salmon|鲑，大马哈鱼
silicon|硅（旧名矽）
regulation|规章，规则
regularity|规则性；整齐，端正
define|规定；立（界限）
provision|规定，条款，条项
replacement|取代；置换
spacious|广阔的，广大的
amplitude|振幅；广大；充足
radial|放射状的
photoelectric|光电的
optical|光的；光学的
shrub|灌木，灌木丛
irrigation|灌溉；（医）冲洗法
inertia|惯性；无力
orchestra|管弦乐队
blast|管乐器的声音
pipe|管乐器
coffin|棺材，灵柩
bureaucracy|官僚主义；官僚机构
monster|怪物；畸形的动植物
client|顾客；诉讼委托人
obstinate|固执的；顽强的
inherent|固有的，生来的
fixture|固定设备
pluck|鼓起（勇气），振作
agitation|鼓动，煸动；搅动
skeleton|骨骼，骷髅；骨架
thigh|股，大腿
cereal|谷类，五谷，禾谷
antique|古代的 n. 古物
assessment|估定；查定
constitute|构成，组成
hound|猎犬
gutter|沟，边沟；檐槽
tribute|献礼；贡物
number|共计，达…之数
commonwealth|联邦
arch|拱门 v. （使）拱起
vault|拱顶；（教堂的）地下墓室
mercury|汞，水银
consolidate|巩固；合并
impartial|公正的，无偏见的
convention|公约，（换俘等）协定
duke|公爵；君主
rooster|公鸡
studio|播音室；工作室
earnings|工资，收入；收益
implement|工具 v. 贯彻
workpiece|工（作）件
combat|跟…战斗，格斗
impart|给予；传递；告诉
energize|供给…能量
vaccinate|给…接种疫苗
flavour|给…调味
insulator|隔离者；绝缘体
lattice|格子结构
dove|鸽子，斑鸠
reveal|告诉，揭示，泄露
plateau|高原；平稳时期
lofty|高耸的；高尚的
tower|高耸，屹立；翱翔
elevation|高度，海拔
intervene|干涉，干预
dry|干巴巴的，枯燥的
olive|橄榄；橄榄树
sentiment|感情；情绪
perception|感知；理解力
sensation|感觉，知觉；轰动
thanksgiving|感恩节
chill|感到寒冷；冷藏
outline|概述，概括
notion|概念；看法
conception|概念，观念，想法
summary|概括的；速决的
generalize|概括出
impress|盖印，在…打记号
mend|修理；改正
duplicate|复制品 v. 复制
complication|复杂，混乱；并发症
complexity|复杂（性）
satellite|附属国
appendix|附录；阑尾
extra|附加物；额外的东西
incidentally|附带地；顺便提及
charge|负荷；充电 v. 装满
negative|负的；（结果）阴性的
corrosion|腐蚀，侵蚀；锈
erosion|腐蚀，侵蚀；糜烂
subsidiary|辅助的，补充的
coach|指导，训练；辅导
answer|符合，适合
emerge|浮现，出现；显露
obedient|服从的，顺从的
obedience|服从，顺从
maintenance|扶养费；维持
veto|否决，否决权；禁止
denial|否定；拒绝相信
buddhism|佛教，释教
dedicate|奉献；献身
flatter|奉承，阿谀，谄媚
pineapple|凤梨，波萝
seam|缝口；接缝；骨缝
landscape|风景，景色，景致
windmill|风车
plump|丰满的
abundance|丰富，充裕
indignation|愤怒，愤慨，义愤
shatter|粉碎，破碎；毁坏
molecular|分子的；克分子的
limb|肢；手臂；腿
offset|抵销
fraction|分数
distract|分散（心思）；打扰
installment|分期付款
split|分裂，分化，派系
detach|分开；派遣（军队）
partition|分开，分割；隔墙
interface|分界面
relay|分程传递；使接替；转播
diverge|分岔；分歧
litter|废物；杂乱 v. 乱扔
abolish|废除，取消
gangster|匪徒，歹徒，暴徒
extraordinarily|非常地，特别地
fly|飞跑；逃跑，消失
aviation|飞行（术）
indulge|放纵（感情），纵情
herd|成群；放牧
magnify|放大，扩大
imitation|仿制品，伪制物
pattern|仿制，仿造，模仿
reproduce|仿造
estate|财产，产业；房地产
hamper|妨碍，阻碍，牵制
handicap|妨碍，使不利
handy|方便的；便于使用的
offence|犯罪，犯规；冒犯
blunder|犯大错 n. 大错
mirror|反映，借鉴
reactor|反应堆
echo|回响
contrary|反对命题
contradict|反驳，否认
propagation|繁殖；传播；蔓延
propagate|传播，普及；繁殖
toss|翻来覆去
decree|法令，政令
flannel|法兰绒
valve|阀，阀门；电子管
originate|发源；首创
spokesman|发言人，代言人
outlet|发泄（感情等）的方法
incidence|发生率，影响；入射
generate|发生，产生；生成
invoice|发票，发货清单
detector|发觉者，探测器
flame|燃烧
exert|发挥（威力），施加
luminous|发光的；夜明的
beam|发光，发热；开怀大笑
motive|发动的，运动的
dynamo|发电机
rattle|发出格格声
dioxide|二氧化物
bait|饵；引诱物
subsequent|尔后的
whereas|而，却，反之
youngster|儿童，少年，年轻人
offspring|儿女，子孙，后代
malice|恶意；蓄意犯罪
spite|恶意，怨恨
nightmare|恶梦；经常的恐惧
yoke|轭，牛轭；枷锁
deprive|夺去；使（人）失去
mountainous|多山的；山一般的
windy|多风的，刮风的
versatile|多方面的；通用的
stew|炖 n. 炖菜
mop|拖把，墩布；洗碗刷
halve|对分；平摊
symmetrical|对称的，匀称的
symmetry|对称（性），匀称
provoke|对…挑衅；激发
resent|对…不满，怨恨
alignment|排成直线；结盟，联合
assert|断言，宣称；维护
affirm|断言，证实
shortage|短缺，不足额
ferry|渡船 v. 运送
jealousy|妒忌，嫉妒，猜忌
cuckoo|杜鹃，布谷鸟
gamble|赌博 v. 冒…的险
jam|堵塞 v. 使…堵塞
distinct|清楚的
solo|独唱，独奏；独唱曲
dictator|独裁者，专政者
linger|逗留，徘徊；拖延
tease|逗乐，戏弄
fighter|战斗机；斗争者
champion|斗士；提倡者
insight|洞察力；洞悉，见识
cavity|洞，穴，空腔
jelly|冻，果冻；胶状物
mobilize|动员，动员起来
grease|动物脂，脂肪
disturbance|动乱；干扰
kinetic|动力（学）的；活动的
orient|东方；亚洲，远东
location|定位，测位
theorem|定理；原理，原则
subscribe|订购；认购；预订
summit|顶点，最高点；极度
sculpture|雕刻品；雕刻（术）
electronics|电子学
pressure|大气压力
capacitor|电容器
capacitance|电容，电容量
electrode|电极；电焊条
electrician|电工，电气技师
telex|电传，用户电报
kindle|点燃，着火
geology|地质学；（某地）地质
basement|地下室；地窖；底层
geographical|地理的；地区（性）的
magistrate|地方法官
mortgage|抵押贷款 v. 抵押
hostile|敌对的；不友好的
whisper|低声地讲；私下说
underestimate|低估，看轻
murmur|低沉连续的声音
equivalent|等面（体）积的
enroll|登记，招收，参军
burner|煤气头
triumphant|得胜的；得意洋洋的
clatter|得得声，卡嗒声
morality|道德，美德，品行
theft|盗窃，偷窃（行为）
attendance|到场；出席人数
between|当中，中间
yolk|蛋黄，卵黄
cartridge|弹药筒
detain|扣押，拘留；耽搁
simple|单纯的；迟钝的
simplicity|单纯，质朴
fill|担任（职务）；填补
jug|带柄水罐，大壶
algebra|代数学
attorney|代理人；辩护律师
deputy|代理人 adj. 副的
representative|代表性的；代议制的
delegate|代表，委员，特派员
gorilla|大猩猩
magnitude|重大；星等
massacre|大屠杀，残杀
stride|大踏步走 n. 大步
embassy|大使馆；大使的职务
ambassador|大使，使节
mansion|大厦，大楼；宅第
multitude|大批，大群；大量
barley|大麦
continental|大陆的，大陆性的
infinity|无穷大
steak|大块牛肉；牛排
butt|大酒桶，桶
largely|主要地
widely|大大地
prairie|大草原，牧场
smash|打碎，打破，粉碎
sneeze|打喷嚏
lighter|打火机，引燃器
snore|打鼾，打呼噜
thresh|打谷，脱粒
forge|打（铁等），锻造
passport|达到目的的手段
inaccessible|达不到的，难接近的
frustrate|挫败
latent|存在但看不见的
frail|脆弱的
fragile|脆弱的；体质弱的
crisp|脆的
catalyst|催化剂；刺激因素
promotion|促进；提升
reckless|粗心大意的；鲁莽的
vulgar|粗俗的，庸俗的
massive|粗大的；大而重的
harsh|粗糙的；严厉的
jungle|丛林，密林，莽丛
follow|从事（职业），经营
overflow|从…中溢出
smart|刺疼，扎疼，剧痛
prick|刺（穿） n. 刺痛
thereafter|此后，以后
magnetism|磁；魅力
porcelain|瓷 adj. 瓷的，瓷制的
initial|词首的
glossary|词汇表；术语汇编
vocabulary|词汇表，词汇汇编
stem|词干
poke|戳，刺；伸（头等）
lipstick|唇膏，口红
stainless|不锈的；纯洁的
sheer|纯粹的；全然的
perpendicular|垂直的
author|创造者，创始人
innovation|创新，改革；新设施
initiative|倡议；新方案
puff|喘气；喷（烟等）
shipwreck|船舶失事
report|传说，议论
infectious|传染的；感染性的
romance|传奇；浪漫文学
herald|传令官；通报者
missionary|传教士
sensor|传感器，灵敏元件
circular|传单，通报，通函
leaflet|传单
convey|传达；传播；转让
pierce|穿透，戳穿
penetration|穿入；渗透
antenna|触角；天线
virgin|处女 adj. 处女的
transaction|交易；处理
penalty|处罚，刑罚，罚款
exclusive|除外的
notorious|臭名昭著的
scandal|丑事，丑闻；耻辱
specimen|抽样，样品
extraction|抽出；提取法
adore|崇拜，爱慕；很喜欢
worship|崇拜；做礼拜
bug|虫子；臭虫
punch|打孔 n. 冲压机
strife|冲突，竞争
equator|赤道，天球赤道
gear|齿轮，传动装置
persist|持续，存留
breakfast|吃早餐
dine|吃饭
proceeding|程序，行动，事项
length|长度
acknowledge|承认；告知收到
shoulder|承担；挑起
integrity|诚实，正直
offer|出现
membership|成员资格；会员人数
systematic|成体系的
kit|成套工具；用具包
commend|称赞，表扬；推荐
brood|沉思，郁闭地沉思
muse|沉思，默想，冥想
meditate|沉思；冥想
hush|沉默 int. 嘘！
immerse|沉浸；给…施洗礼
repeal|撤销
lathe|车床 v. 用车床加工
row|吵架，口角
mock|嘲弄，挖苦
reign|（某君主的）统治时期
supersonic|超声的，超声速的
ultrasonic|超声的 n. 超声波
surpass|超过，超越，胜过
nickname|绰号，诨号
waggon|敞蓬车厢
spectacle|场面，景象；奇观
resident|常住者
haunt|（鬼魂）经常出没
visit|拜访
frequent|常见的；频繁的
shovel|铲，铁铲 v. 铲
toad|蟾蜍，癞蛤蟆
diesel|柴油发动机，内燃机
errand|差使，差事
ascertain|查明，确定，弄清
horizon|地平线
tactics|战术，兵法
grassy|草多的
herb|草本植物；香草
groove|槽
manipulate|操作；操纵，控制
hatch|策划；密谋
warehouse|仓库，货栈
cruelty|残酷；残酷行为
napkin|餐巾（纸）
participate|参与
senator|参议员
reference|参考文献；参照物
participant|参加者
spectator|参观者，观众
parameter|参（变）数；参量
recipe|菜谱，烹饪法
assumption|假定
rule|裁决，裁定
substance|内容，本旨；财产
friction|摩擦
sermon|布道，讲道；说教
absent|不在的
disagreement|争论；不一致
awkward|令人尴尬的
immortal|不朽的；永生的
wretched|不幸的
misfortune|不幸，灾祸，灾难
incompatible|不相容的
instability|不稳定性
incomplete|不完全的，未完成的
stuffy|不透气的，闷热的
opaque|不透明的
improper|不适当的；不合理的
dissatisfaction|不满，不平
watertight|不漏水的，防水的
inevitably|不可避免地
irrespective|不考虑的，不顾的
inaccurate|不精密的，不准确的
unreasonable|不讲道理的；过高的
undesirable|不合需要的；讨厌的
unfit|不合适的；无能力的
absurd|不合理的，荒唐的
irregularity|不规则；不整齐
disregard|不管，不顾 n. 忽视
uncertain|不定的；无常的
impurity|杂质；不纯
inadequate|不充足的，不适当的
invariably|不变地，永恒地
uneasy|不安的；拘束的
mammal|哺乳动物
supplement|补角
complement|补充 n. 补足（物）
compensation|补偿，赔偿，赔偿费
humanitarian|博爱的 n. 慈善家
barge|驳船；大型游船
fluctuation|波动
fluctuate|波动，使波动
invalid|病人
ward|病房，病室；监房
strength|兵力；强度
icy|冰冷的；冷冰冰的
objective|目标 adj. 宾格的
villa|别墅
characterize|表现…的特性
signify|表示，意味着
manifest|表明 adj. 明显的
seemingly|表面上，外表上
superficial|表面的；肤浅的
criterion|标准，准则，尺度
norm|标准，规范；平均数
heading|标题，题词，题名
reason|论证，推断
advocate|拥护 n. 辩护律师
discrimination|歧视；辨别；识别力
transform|变换
loosen|变松
alteration|变更，改变
fall|变成，成为，陷入
program|编制程序
edit|编辑，编纂；校订
verge|边缘，边界
rim|边；边缘，（眼镜）框
hearth|壁炉地面；炉边
fireplace|壁炉
patron|庇护人；赞助人
diploma|毕业文凭，学位证书
indispensable|必不可少的，必需的
sullen|绷着脸不高兴的
bandage|绷带，包带
breakdown|崩溃，倒塌，失败
essence|本质，本体
captive|被俘虏的
reverse|背面，反面
deviation|背离，偏离；偏差
arctic|北极的 n. 北极
tragic|悲惨的；悲剧的
woe|悲哀，悲痛，苦恼
grief|悲哀，悲痛，悲伤
firework|爆竹，花炮，烟火
storm|爆发 v. 猛攻
tyranny|暴政，专制；残暴
wrath|暴怒，狂怒，愤慨
tyrant|暴君；专制君主
panther|豹，黑豹；美洲狮
leopard|豹
grumble|抱怨，发牢骚
announce|报告…的来到
vengeance|报复，报仇，复仇
fortress|堡垒，要塞
assurance|保证
fuse|保险丝；导火线
reservation|预定，预订；保留意见
safeguard|保护措施
preservation|保存，储藏；保持
saturation|饱和（状态）；浸透
mist|薄雾 v. 下薄雾
chip|薄片，碎片
inclusive|包括的
siege|包围，围攻，围困
embrace|包括，包含
baseball|棒球运动；棒球
hemisphere|半球
radius|半径距离，半径范围
scar|瘢痕
liner|班船，定期班机
trigger|扳机 v. 触发，引起
tar|柏油；焦油
blind|百叶窗；窗帘；遮帘
shutter|百叶窗；（相机）快门
lily|百合，百合花
millionaire|百分富翁，巨富
white|白种（人）的
blond|白肤金发碧眼的人
idiot|白痴；傻子
bank|把钱存入银行
tabulate|把…制成表
bestow|把…赠与
subdivide|把…再分
dock|把…引入船坞
straighten|把…弄直；挺起来
flatten|把…弄平；击倒
ascribe|把…归于
except|把…除外，除去
entitle|把…称作
ballet|芭蕾舞；芭蕾舞剧
haughty|傲慢的，轻蔑的
foul|肮脏的；丑恶的
assassinate|暗杀，行刺；中伤
burial|安葬，埋葬；埋藏
luxurious|爱好奢侈的，豪华的
patriot|爱国者，爱国主义者
patriotic|爱国的
dwarf|矮子，侏儒
stout|肥胖的；厚实牢固的
alas|唉，哎呀
egyptian|埃及的 n. 埃及人
pathetic|哀婉动人的；可怜的
should|应该；竟然会
ought|早应该，本应
scripture|《圣经》；圣书
referee|（足球等）裁判员
pendulum|（钟等的）摆
shuttle|（织机的）梭
outbreak|（战争、愤怒等）爆发
market|推销
gross|（语言、举止）粗俗的
heave|（用力地）举起；抛
pop|（意外地）出现
lining|（衣服里的）衬里
mild|味淡的
panel|（选定的）专门小组
rigorous|严格的
climax|顶点
epoch|（新）时代；历元
shrimp|（小）虾，河虾，褐虾
peak|（物体的）尖端
cane|（藤等）茎；手杖
drain|（水等）流掉
switch|（树木的）软枝条
board|付费（在某人家里）膳宿
immigrate|（使）移居入境
disperse|（使）分散；驱散
lump|（使）成团，结块
deviate|（使）背离，偏离
pose|（使）摆好姿势
expenditure|（时间等）支出，消费
elapse|（时间）过去，消逝
hoarse|（声音）嘶哑的
clearing|（森林中的）空旷地
shade|（色彩的）浓淡，深浅
eclipse|（日，月）食
constitution|（人的）体格，素质
spill|（人）摔下，跌下
unanimous|（全体）一致的
quiver|（轻微地）颤动
perch|（禽鸟的）栖木
span|（桥墩间的）墩距
pier|码头；（桥）墩
frock|（女）连衣裙
flutter|（鸟）振翼；飘动
resume|（谋职者的）个人简历
clown|（马戏的）小丑，丑角
pace|踱步
lounge|（旅馆等的）休息室
pope|（罗马天主教的）教皇
axle|（轮）轴，车轴，心棒
measurement|（量得的）尺寸，大小
realization|（理想等的）实现
chord|和弦
pyjamas|（宽大的）睡衣裤
elegant|（举止、服饰等）雅致的
hard|（酒）烈性的
refreshment|（精力的）恢复，爽快
ticket|（交通违章）罚款传票
gesture|（讲话时等）做手势
situation|（建筑物等的）位置
software|（计算机的）软件
bishop|（基督教的）主教
insert|插入，放进
kernel|（果实的）核；谷粒
wisdom|智慧
growl|（狗等）嗥叫；咆哮
shaft|（工具的）柄，杆状物
buzz|（蜂等）嗡嗡叫
breed|（动物）品种
ear|（稻麦等的）穗
dean|（大学）院长，系主任
fertile|（创造力）丰富的
sink|（厨房内的）洗涤槽
versus|（比赛等中）对
ranch|（北美洲的）大牧场
grope|（暗中）摸索，探索
pedlar|（挨户兜售的）小贩
rally|集合
squat|（使）蹲下
fling|（用力）扔，抛
scrub|擦洗，擦净 n. 擦洗
tread|踩，踏，践踏
crack|发出爆裂声
slander|诽谤，诋毁 v. 诽谤，诋毁
escort|护卫，护送 n. 护卫者，护送车辆
swell|使膨胀；隆起
menace|威胁 v. （进行）威胁
tramp|以沉重的脚步走（过） n. 跋涉
trample|践踏，蹂躏 n. 践踏，蹂躏
suicide|自杀 v. 自杀
tighten|（使）变紧
jingle|（使）丁当响
fret|（使）烦恼
thrill|（使）激动
deflect|（使）偏斜
tilt|（使）倾斜
revolve|（使）旋转
rotate|（使）旋转
compensate|补偿，赔偿
default|不履行义务 v. 不履行义务
infer|推断
repay|偿还；报答
scoff|嘲笑，嘲弄
hoe|锄地
retort|反击；反驳
broaden|放宽，变阔
decompose|腐败；分解
chorus|合唱，齐声说
supervise|监督，监视
beware|谨防，当心
grab|攫取，抓取
entreat|恳求
concentrate|浓缩，提浓
urge|强烈希望
riot|骚乱，暴乱 v. 发动骚乱
shrug|耸（肩） n. 耸肩
revive|苏醒；复兴
terminate|停止，终止
solidify|凝固
dazzle|使目眩；使倾倒
transplant|移植（器官、皮肤等）；移植，移种（植物）
xerox|用静电复印
peck|啄，啄起
trot|（马）小跑 n. （马）小跑；慢跑
ridicule|嘲弄，挖苦 n. 嘲弄，挖苦
chatter|喋喋不休 n. 喋喋不休
sneer|冷笑；嘲笑 n. 冷笑；嘲笑
boycott|联合抵制 n. 抵制行动，受抵制时期
plunder|掠夺，劫掠 n. 掠夺，抢劫
endeavor|努力，尽力 n. 努力，尝试
scramble|爬行，攀登 n. 爬行，攀登
flap|拍打 n. 拍打，拍动
slaughter|屠杀；屠宰 n. 屠杀；屠宰
tow|拖引，牵引 n. 拖引，牵引
credit|相信，信任 n. 相信，信任
clockwise|顺时针方向转地 adj. 顺时针方向转的
headlong|头向前地 adj. 头向前的
counter|相反地 adj. 相反的
eastward|向东
moslem|穆斯林 adj. 穆斯林的
melancholy|忧郁的 adj. 忧郁，悲伤
bulletin|告示，公告，公报
allowance|津贴，补助费
cancel|取消， 撤销， 删去
numerous|众多的
surgeon|外科医生
analyse|分析； 分解， 解析
abrupt|突然的， 意外的； 唐突的， 鲁莽的
spacious|宽广的， 宽敞的
disapproval|不赞成
spontaneous|自发的， 无意识的； 自然的， 天真率直的
remote|遥远的， 偏僻的； 关系疏远的； 脱离的； 绝少的； 微乎其微的； 孤高的， 冷淡的
cafeteria|自助餐馆， 自助食堂
rupture|破裂 n. 破裂，裂开；决裂，断绝
wreck|失事，残骸；精神或身体已垮的人 vt. 破坏
virgin|未经开发的， 未经使用的， 未经触动的； 处女的 n. 处女，未婚女子
afflict|使苦恼， 折磨
reproach|n&vt. 责备， 批评
fluctuate|波动， 涨落， 起伏
compartment|卧车包房， 隔间； 分隔的空间
gloomy|忧郁的， 沮丧的； 令人沮丧的； 昏暗的， 阴沉的
kidnap|绑架， 诱拐
warrant|授权令；理由，根据 vt. 证明…是正当的
calculate|计算， 推算； 计划， 打算
persistent|坚持不懈的， 执意的； 持续的
authorize|授权， 批准
sake|缘故， 理由
audience|听众， 观众； 读者
rehearsal|排练， 排演
sniff|以鼻吸气，用力吸入；嗅，闻 n. 吸气； 嗅， 闻
narrative|叙述文， 故事； 叙述， 讲述
possess|占用， 拥有
coincide|同时发生； 相符， 相一致； 位置重合， 重叠
neutral|中立的， 中性的
scratch|抓，搔，扒；刮擦，刻划 n. 抓痕， 划痕； 抓， 搔， 刮
analysis|分析， 分析报告； 分解， 解析
devise|设计， 发明
cooperative|有合作意向的，乐意合作的；合作的，协作的 n. 合作社， 合作商店
triple|三部分的，三方的；三倍的，三重的 v. 增至三倍
clutch|企图抓住 vt. 抓紧，紧握 n. 离合器； 掌握， 控制； 把握， 抓紧
temper|韧度；心情，情绪 vt. 调和， 使缓和； 回火
grope|暗中摸索，搜索；探索，搜寻 vt. 摸索
rejoice|感到高兴， 充满喜悦
frantic|慌乱不安的； 发疯似的， 发狂的
tickle|发痒 vt. 使发痒；使高兴，逗乐 n. 痒
object|反对， 不赞成 n. 实物， 物体； 目的， 目标； 对象， 客体； 宾语
humble|谦逊的；地位低下的；简陋的 vt. 使谦恭； 使卑下
commodity|商品， 货物
cliff|悬崖， 峭壁
obedient|服从的， 顺从的
infinite|无限的， 无数的
misery|痛苦， 苦恼， 苦难； 悲惨的境遇， 贫苦
blur|变模糊 n. 模糊，模糊的东西
suffice|足够
concede|让步， 认输 vt. 承认，承认…为真；承认失败；允许，让予
notable|值得注意的，显著的；著名的 n. 名人， 要人
plausible|似有道理的， 似乎正确的， 貌似可信的
equator|赤道
commission|委任状；委员会；佣金，回扣；授权，委托 vt. 委任， 委托
staircase|楼梯
flip|〈口〉无理的， 轻率的， 轻浮的 vt. 快速翻动，转动 n. 捻掷，轻抛；轻拍
rational|理性的， 理智的； 合理的
barricade|路障，栅栏，障碍 vt. 设路障于， 挡住
resume|重新开始， 继续， 恢复 n. 摘要， 概要； 简历
provocative|挑衅的， 煽动的， 刺激的； 挑逗的
committee|委员会， 全体委员
posture|摆出姿势， 装模作样 n. 姿势，姿态；看法，态度
spiral|盘旋上升； 不断急剧地上升 adj. 螺旋的 n. 螺旋，螺旋式的上升
subtle|微妙的， 难以捉摸的； 诡秘的， 狡诈的； 隐约的
component|组成的， 构成的 n. 组成部分，部件，组件
overwhelm|使受不了， 使不知所措； 征服， 制服
suite|套间； 一套家具； 套， 组， 系列
consultant|顾问； 会诊医师， 专科医生
disguise|假扮，化装，伪装；掩盖，掩饰 n. 用来伪装的东西； 伪装， 掩饰
imperial|帝国的， 帝王的； 英制的
facet|一个方面； 面
liberal|心胸宽大的， 慷慨的； 自由的， 自由主义的
surgery|外科， 外科手术； 手术室
harmony|调和； 协调； 和谐
violent|暴力引起的， 强暴的； 猛烈的， 剧烈的
resolve|决定；解决；分解 n. 决心
cozy|舒适的； 亲切友好的
confront|迎面遇到， 遭遇； 勇敢地面对， 正视； 使对质， 使当面对证
dominate|在…中占首要地位； 支配， 统治； 耸立于， 俯视； 拥有优势
imitate|模仿； 仿效； 仿制
deadly|非常， 极度地 adj. 致死的，致命的；不共戴天的；极度的，十足的
compute|计算， 估算
institution|协会； 制度； 习俗
huddle|聚集在一起，挤作一团；把身子蜷成一团，蜷缩 vt. 使聚集在一起 n. 挤在一起的人； 一堆杂乱的东西
skeleton|骨骼； 框架， 骨干； 梗概， 提要
ambition|雄心， 抱负， 野心； 期望得到的东西
intersection|道路交叉口， 交点
exceed|超过， 胜过， 超出
implement|使生效， 履行， 实施 n. 工具， 器具， 用具
disperse|分散， 赶散； 消散， 驱散 vt. 使分散，散开；使消散，消失
avert|防止， 避免； 转移
fantasy|想象， 幻想； 想象的产物
shipment|装运， 装船； 装载的货物
vicious|恶毒的， 凶残的； 剧烈的， 严重的
lace|网眼花边，透孔织品；鞋带，系带 vt. 用系带束紧
enormous|巨大的， 庞大的
external|外部的， 外面的
gorgeous|华丽的， 灿烂的， 绚丽的； 令人十分愉快的， 极好的
circumstance|情况，条件，境遇；
authority|官方； 权力； 当权者， 行政管理机构； 权威， 专家
erosion|腐蚀， 侵蚀， 磨损； 削弱， 减少
ascend|渐渐上升，升高 vt. 攀登， 登上
provided|假如， 若是
instrument|仪器， 工具； 乐器
medium|中等的 n. 媒质，媒介物；传导体
indispensable|必不可少的， 必需的
lens|透镜， 镜片； 镜头
embody|代表， 表现， 体现； 包括； 包含； 收录
fatal|致命的， 灾难性的， 毁灭性的； 重大的， 决定性的
motive|动机， 目的
envisage|想象， 设想
wrestle|摔跤； 斗争， 搏斗
motivate|作为…的动机； 激励， 激发
marginal|微小的， 少量的； 不重要的； 仅以微弱多数票获胜的； 记在页边的， 有旁注的
spoil|变质 vt. 损坏，糟蹋；宠坏，溺爱 n. 战利品， 掠夺物
multiply|增加， 繁殖； 乘
pasture|牧草地，牧场 vt. 放牧
approval|赞成， 同意； 认可， 批准
mobile|运动的；流动的；多变的 n. 移动电话
multiple|复合的；多重的，多样的 n. 倍数
evolution|进化， 演化； 发展
peak|达到高峰； 达到最大值 adj. 最大值的；高峰的 n. 山顶，顶点，顶峰
magnet|磁铁， 磁体； 有吸引力的人和事物
concentrate|全神贯注，全力以赴；集中，聚集；浓缩 n. 浓缩物， 浓缩液
expose|使暴露， 揭露
versatile|多才多艺的， 有多种技能的； 有多种用途的， 多功能的， 万用的
versus|以…为对手， 对； 与…相对， 与…相比之下
complaint|抱怨， 怨言； 控告
permissible|可允许的， 许可的
cancer|癌， 癌症， 肿瘤
splash|溅，泼 n. 溅泼声； 溅出的水； 斑点
inject|注射， 给…注射； 注入， 引入， 投入
romance|恋爱， 恋爱关系； 浪漫气氛， 传奇色彩； 爱情小说， 传奇故事
offense|犯规， 违法行为； 冒犯， 得罪
atlas|地图集
invisible|看不见的， 无形的
focus|聚焦；集中 n. 焦点， 中心
hamper|妨碍，束缚，限制 n. 大篮子
motel|汽车旅馆
approach|向…靠近 n. 靠近； 途径， 方式
exaggeration|夸张； 夸大之词
peg|小钉，栓，挂物钉；桩 vt. 用钉子钉， 用钉固定； 限定； 将…看成， 将…归入
myth|杜撰出来的人； 神话
decisive|决定性的； 坚定的， 果断的， 决断的
concise|简明的， 简要的
implication|含意， 暗示， 暗指； 卷入， 牵连
thesis|论文， 毕业论文； 论题， 论点
bump|碰，撞；
reservation|预订； 保留； 犹豫； 居留地
revive|复苏
cordial|热情友好的， 热诚的
timid|羞怯的， 胆小的
loyalty|忠诚， 忠心
dismiss|不再考虑； 解雇， 解散； 驳回
underlying|在下面的； 含蓄的； 潜在的
reform|n&v. 改革， 改良， 改造； 改正， 改过自新
install|安装， 设置； 使就职， 任命
ensue|接着发生， 接踵而来， 因而产生
indication|指出， 指示； 迹象， 暗示
bulk|变得越来越大； 使更大 n. 物体，体积；大批
bull|公牛； 雄兽； 买进证券投机图利者， 看涨的人
champion|冠军， 得胜者； 捍卫者， 拥护者
ceramic|陶器的 n. 陶瓷器
queer|奇怪的， 异常的； 不舒服的， 眩晕的
successor|接替的人或事物， 继任者
enlightenment|启发， 开导； 开明， 文明
booklet|小册子
magnificent|壮丽的， 华丽的； 极好的
stagger|摇晃，蹒跚 vt. 使吃惊；使错开，使交错 n. 蹒跚， 踉跄
irony|反话， 冷嘲， 嘲弄； 具有讽刺意味的事
restrict|限制， 约束， 限定
bandage|绷带 vt. 用绷带绑扎
prevalence|流行
scrap|碎片，碎屑；废金属；残羹剩饭；少量，点滴 vt. 废弃， 抛弃
syndrome|综合病症， 综合症状； 一系列表现
tow|n&vt. 拖， 拉， 牵引
imperative|必要的；紧急的，极重要的；命令的 n. 必要的事， 必须完成的事； 【语】祈使语气
meadow|草地
hitherto|到目前为止， 迄今
energetic|精力充沛的， 充满活力的
haul|拖，拉；拖运，运送 n. 拖， 拉， 托运； 一次获得的数量
avail|有帮助； 有益； 有用 n. 效用，利益，帮助
consequence|结果， 后果； 重要， 重大
linear|线的， 直线的， 线状的； 长度的； 线性的
robust|强壮的， 健康的
dominant|占优势的， 支配的， 统治的； 居高临下的， 高耸的
premier|首要的， 首位的， 首次的 n. 总理，首相
peel|剥落，脱皮 vt. 削…的皮，剥…的壳 n. 皮， 外衣
intellectual|智力的 n. 知识分子
reclaim|要回； 开垦； 回收
denounce|谴责， 指责； 告发
verge|接近， 濒临 n. 边，边缘
pastry|油酥面团， 酥皮糕点
messenger|送信人， 信使
disable|丧失能力， 伤残
irrespective|不考虑的， 不顾及的
entity|实体， 独立存在体， 实际存在物
prohibit|禁止， 不准
bacteria|细菌
fuel|燃料，燃料剂 vt. 给…加燃料； 刺激
hostile|敌方的， 不友善的
reign|当政， 统治； 占主导地位 n. 君主的统治，君主的统治时期
tempo|速度； 节奏， 行进速度
descendant|后裔， 后代
foresee|预见， 预知
bruise|青肿，挫伤；伤痕，擦痕 vt. 打青， 使受淤伤； 挫伤， 伤害
associate|把…联系在一起；使联合，结合；交往	[ə'səuʃiət] adj. 副的 n. 伙伴，同事
gown|女礼服， 女裙服； 长袍； 罩衣
crawl|n&v. 爬行， 蠕动； 缓慢行进
identical|完全相同的， 同一的
plead|恳求，请求；申诉，答辩，辩护 vt. 为…辩护， 提出…为理由
kidney|肾， 肾脏
gleam|n&vi. 闪亮， 闪烁； 闪现， 流露
ambitious|有抱负的， 雄心勃勃的； 有野心的
academic|学院的；学术的；纯理论的，不切实际的 n. 大学教师
function|工作， 运行； 起作用 n. 功能，职务；【数】函数；重大聚会
stock|储备 adj. 常用的， 常备的 n. 原料，库存品；股本，公债；世系，血统；汤汁；家畜，牲畜
sneak|偷偷地走，溜 vt. 偷偷地做
void|无效的；没有的，缺乏的 n. 空虚感，寂寞感；真空，空白 vt. 使无效
comparison|比较， 对照； 比拟， 比喻
surge|蜂拥而出；洋溢，奔放；汹涌，奔腾 n. 洋溢， 奔放； 急剧上升， 猛增； 浪涛般汹涌奔腾
swap|n&v. 交换
ritual|作为仪式一部分的； 例行的 n. 仪式；例行公事，老规矩
liability|责任； 负债， 债务； 不利条件， 起妨碍作用的人
hatch|孵出；筹划， n. 舱门； 开口； 孵化
patriot|爱国者， 爱国主义者
tick|发出滴答声 n. 记号，勾号；滴答声 vt. 给…标记号
basis|基础， 根据； 原则
tutor|当…导师， 当…家庭教师 n. 导师；家庭教师，私人教师
senator|参议员
successive|连续的， 接连的
quantify|确定…的数量， 量化
reconcile|使协调； 使和解； 使顺从， 使甘心
tempt|吸引， 引起…的兴趣； 引诱， 诱惑
obligation|义务， 责任
paperback|平装本， 简装本
evil|坏的 n. 邪恶，祸害
rarely|不常， 难得
hawk|鹰，隼；“鹰派”人物 vt. 叫卖， 兜售
twist|缠绕，盘绕；转动，旋动；捻，搓；歪曲，曲解；扭歪，扭伤；曲折前进；转身 n. 扭弯； 转折， 转变； 弯曲， 曲折处
forthcoming|即将到来的； 可得到的； 乐于提供消息的
patriotic|爱国的， 有爱国心的， 显示爱国精神的
complication|困难， 难题； 并发症
perplex|使困惑， 使费解； 使复杂化
combat|战争，斗争，格斗 vt. 与…斗争， 与…战斗
despise|鄙视， 看不起
levy|征收 n. 征税， 税款
indulge|沉溺， 纵容自己， 肆意从事 vt. 使沉溺于，满足；纵容，迁就
intimidate|恐吓， 威胁
effective|有效的； 有影响的
unity|单一， 统一， 团结； 和睦， 协调
pursue|继续， 从事； 追赶， 追踪； 追求
vulgar|粗野的， 下流的； 庸俗的， 粗俗的
catastrophe|大灾难， 灾祸
convey|表达； 传递； 运送， 输送
design|设计；预定，指定 n. 设计， 构想； 图样； 企图
generous|慷慨的， 宽厚的； 大量的
coincidence|巧合， 巧事； 一致， 符合
victim|牺牲者； 受害者
bust|爆裂，坏掉 vt. 打破，打碎 n. 胸像， 半身像； 胸部， 胸围
skull|颅骨， 脑壳
hysterical|情绪异常激动的， 歇斯底里般的
lane|小路， 跑道； 航道， 航线
contaminate|弄脏， 污染
ammunition|弹药， 军火
chief|主要的，为首的；总的 n. 首领， 长官； 酋长， 族长
accord|相符合， 相一致， 相和谐； 授予， 赠与， 给予 n. 一致，符合；谅解，协议
foremost|最好的， 最著名的， 最重要的
automatic|自动的； 必然发生的； 无意识的 n. 自动机械
despite|不管， 不顾
consecutive|连续的， 连贯的
probe|探索，查究，调查；用探针探查，探测 n. 探针， 探测器； 探索， 调查
assimilation|同化， 同化作用； 消化
groan|呻吟，抱怨；发出呻吟般的声音 n. 呻吟， 抱怨； 呻吟般的声音
industrial|工业的， 产业的
conduct|举止，行为；指导；管理，实施	[kən'dʌkt] vt. 进行； 管理， 指挥， 引导； 传输， 传导
velvet|天鹅绒， 丝绒
quantitative|量的， 定量的
stable|稳定的，不变的；沉稳的，持重的 n. 厩， 马厩， 牛棚
reunion|重聚， 团聚； 聚会， 联谊活动
fantastic|极好的， 极出色的； 了不起的； 极大的； 难以相信的； 异想天开的， 不实际的； 奇异的， 古怪的
drainage|排水系统， 下水道； 排水， 放水
respond|回答， 答复； 作出反应， 响应
incident|发生的事， 事件
lame|跛的， 瘸的； 站不住脚的， 差劲的； 蹩脚的
tub|桶， 塑料杯， 纸杯； 盆， 洗澡盆， 浴缸
cluster|群集，丛生 n. 串，簇；群，组 vt. 使群集， 集中
prey|捕食； 折磨， 使烦恼 n. 被捕食的动物，捕获物；受害者
apparatus|器械， 器具， 仪器； 机构， 组织
lieutenant|陆军中尉； 海军上尉
tug|用力拖 n. 拖船； 猛拉， 牵引
expedition|旅行， 远征； 远征队， 探险队， 考察队； 迅速， 动作敏捷
decay|腐烂，衰败 n. 腐烂， 衰败状态
grieve|感到悲痛，伤心 vt. 使伤心， 为…而伤心
absorb|吸收； 吸引…的注意， 使全神贯注； 把…并入， 同化
concern|关切的事，有关的事；关心，挂念；关系，关联；公司，企业 vt. 涉及， 有关； 使关心， 使担心
fracture|断裂，折断 n. 裂缝， 裂痕； 折断
rectify|纠正， 修复
integrity|正直， 诚实， 诚恳； 完整， 完全， 完善
refrain|抑制，克制，戒除 n. 叠句， 副歌
pact|契约， 协定， 条约
notation|记号， 标记法
merge|结合， 合并， 合为一体
liable|易于…的， 可能的
recycle|回收利用
dock|靠码头， 进港 n. 码头，船埠；被告席 vt. 使靠码头；扣
marsh|沼泽， 湿地
element|成分， 要素， 元素； 基础， 纲要； 自然力
confidential|秘密的， 机密的； 表示信任的； 担任机密工作的
abundant|丰富的， 富裕的； 大量的， 充足的
exclaim|呼喊， 惊叫
ballet|芭蕾舞， 芭蕾舞剧； 芭蕾舞团
mute|缄默的，无声的；哑的，不会说话的；不发音的 vt. 消除， 减轻
courtesy|谦恭有礼； 有礼貌的举止
deteriorate|恶化， 变坏
warehouse|仓库， 货栈
recognize|认出， 识别； 承认， 确认， 认可； 赏识， 表彰， 报偿
restraint|抑制， 限制， 克制； 约束措施， 约束条件
pollutant|污染物质
bamboo|竹， 竹子
input|输入；投入的资金，输入的数据 vt. 把…输入计算机
induce|引导， 劝； 引起， 导致
abnormal|反常的， 异常的
shrewd|机灵的， 敏锐的， 精明的
stereotype|陈规，老套，固定的模式 vt. 对…形成固定看法
molecule|分子
enroll|入学，加入 vt. 招收， 吸收
resign|辞职；听任 vt. 辞去， 放弃； 使顺从
safeguard|保护，维护 n. 预防措施； 保证条款
diligent|勤勉的， 勤奋的
sophisticated|老于世故的； 高级的； 精密的， 复杂的； 高雅的
entertainment|娱乐， 文娱节目， 表演会； 招待， 款待， 请客
reside|居住， 定居； 存在， 在于
indicative|标示的，指示的，象征的；陈述的 n. 【语】陈述语气
ward|病房； 区； 受监护人
dread|担忧，忧虑；惧怕 n. 担忧， 畏惧
scrutiny|详细检查， 仔细观察
chase|n&vt. 追逐， 追赶， 追求
accident|意外， 事故
promote|促进， 增进， 发扬； 提升； 宣传， 推销
routine|例行的， 常规的 n. 例行公事，惯例，惯常的程序
attack|n&vt. 攻击， 进攻； 突然发作
divorce|离婚，离异 vt. 离婚； 分离， 脱离
tariff|关税， 税率； 价目表， 收费表
attach|缚， 系， 贴， 附加； 使依恋， 使喜爱； 使附属； 认为有
graphic|生动的， 形象的； 绘画的， 文字的， 图表的
convict|证明…有罪，宣判…有罪['kɒnvɪkt] n. 囚犯
retention|保留， 保持
creation|创造， 创建； 创造的作品， 产物； 宇宙， 天地万物
legislation|法律， 法规； 立法， 法律的制定
dodge|闪身躲开 vt. 回避，逃避 n. 托辞， 伎俩； 躲闪， 躲避
ingredient|组成部分， 原料； 要素
surplus|过剩的， 多余的 n. 过剩，剩余，盈余
consolidate|巩固， 加强； 联为一体， 合并
correspondence|信件， 函件； 通信， 通信联系； 符合， 一致， 相似
inhibit|阻止， 妨碍， 抑制
refresh|振作精神， 恢复活力
intimate|亲密的，个人的 n. 至交， 密友 vt. 暗示， 提示
shove|用力推，挤 vt. 乱推，挤；乱塞，随意放 n. 猛推
theft|偷窃， 失窃
disclose|揭露， 泄露， 透露
religion|宗教， 宗教信仰
yacht|快艇， 帆船， 游艇
mistress|情妇； 主妇， 女主人
oxide|氧化物
miniature|小型的，微小的 n. 微小的模型， 缩影； 微型画， 微型人物像
clan|宗族， 家族
economical|节约的； 经济学的
prosperous|繁荣的， 兴旺的
polish|磨光；修改，润色，使优美 n. 擦光剂
reassess|再评价
cabinet|橱， 柜； 内阁
optical|眼的， 视觉的； 光学的
evoke|唤起， 引起， 使人想起
insurance|保险； 保险费
dazzle|使眩目，耀；使赞叹不已；使倾倒 n. 耀眼的光； 令人赞叹的东西
principle|原则， 原理， 道义； 基本信念， 信条
thigh|大腿
tedious|冗长乏味的， 沉闷的
tilt|倾斜，倾侧 n. 倾斜， 倾侧
inferiority|自卑； 次等
participant|参加者， 参与者
initiate|开始， 创造， 发起； 使初步了解； 接纳， 让…加入 n. 新加入组织的人
domestic|本国的； 家庭的； 驯养的
glare|怒目而视；发射强光，发出刺眼的光线 n. 强光； 怒视， 瞪眼； 炫耀， 张扬
irrigation|灌溉
compile|汇编； 编制， 编纂
vitality|活力； 生机， 元气
locomotive|机车
tile|瓦，瓷砖 vt. 铺瓦于， 贴瓷砖于
donation|捐款， 捐赠物； 捐赠， 赠送
immense|广大的， 巨大的； 无限的
inherent|内在的； 固有的， 生来就有的
stability|稳定， 稳固
budget|规划，安排；编预算 adj. 低廉的， 收费公道的 n. 预算，预算拨款
radiate|发出， 辐射； 流露， 显示
given|规定的，特定的；假设的，已知的；有癖好的，有倾向的 prep. 考虑到
perish|丧生， 毁灭， 消亡； 失去弹性， 老化
pastime|消遣， 娱乐
ultimate|最后的，最终的 n. 终极， 顶点
adapt|使适应； 改编
prosecute|起诉， 告发 vt. 对…提起公诉，告发，检举；继续从事
batch|一批， 一组， 一群； 一批生产量
merit|长处，优点；价值；功劳，成绩 vt. 值得， 应受
verbal|口头的； 用言辞的， 用文字的； 动词的
solicitor|初级律师， 事务律师
intrinsic|固有的； 本质的； 内在的
proximity|接近， 邻近
luminous|发光的， 发亮的； 光明的
lash|将系牢；鞭打，抽打；猛烈打击；猛烈抨击，严厉斥责 n. 鞭打； 假睫毛； 鞭梢
receipt|发票， 收据； 收入， 进款； 收到， 接到
assume|假定， 假设； 臆断； 承担， 担任； 呈现
predestine|预先确定； 注定
chant|反复有节奏地喊叫；吟诵，咏唱 n. 反复有节奏的喊叫； 赞美诗， 圣歌
destiny|命运； 定数， 天命
capsule|胶囊； 航天舱， 密封舱
concept|概念， 观念； 设想
resistant|抵抗的； 抗…的， 耐…的
ozone|臭氧
indefinite|无限期的； 模糊的， 不确定的
disaster|灾难， 灾祸， 天灾； 彻底的失败
ecology|生态； 生态学
minimal|最小的， 最低限度的
cocktail|鸡尾酒； 餐前开胃小吃； 混合物
enhance|提高， 增加， 加强
convention|习俗， 惯例； 公约； 会议
disease|病， 疾病； 不健全， 弊端
calcium|钙
notwithstanding|尽管
suspicion|怀疑， 疑心， 猜疑； 一点儿， 少量
purchase|买，购买 n. 购买； 购买的物品
refusal|拒绝
disposable|可任意使用的 n. 一次性物品， 不回收物品
bypass|旁道，迂回道 vt. 绕过， 绕…走； 越过， 置…于不顾
silicon|硅
clarity|清楚， 明晰
fund|资金，基金；存款 vt. 为…提供资金
typical|典型的， 有代表性的
recipient|接受者， 接收者
commonwealth|[C-]英联邦； 联邦， 联合体
watt|瓦
buzz|发出嗡嗡声；忙乱，急行；发出嘈杂的谈话声 n. 嗡嗡声； 嘈杂的谈话声
finance|财政，金融；财源，财务情况 vt. 为…提供资金
incur|招致， 引起； 遭受
notorious|臭名昭著的， 声名狼藉的
assassination|刺杀， 暗杀
infant|婴儿的， 幼稚的 n. 婴儿
gland|腺
premise|房屋和地基， 经营场址； 前提， 假设
circus|马戏， 马戏团； 喧闹的场面； 环形广场
controversial|引起争论的， 有争议的
attain|达到， 获得； 完成
deprive|剥夺， 使丧失
tenant|房客， 佃户
resultant|作为结果的， 因而发生的
pest|有害生物， 害虫； 讨厌的人
pedal|踩踏板，骑车 n. 踏板，踏脚 vt. 脚蹬， 踩动…的踏板
batter|连续猛击 n. 面糊
heritage|遗产； 继承物； 传统
supreme|最高的， 最大的； 极度的， 最重要的
hostage|人质
priority|优先， 重点； 优先考虑的事
slope|倾斜 n. 倾斜，斜面
inlet|小湾， 水湾； 进口， 入口
metallic|金属的， 金属制的； 有金属特性的， 像金属的
shuttle|穿梭般来回 n. 短程穿梭运行的飞机；航天飞机；梭子 vt. 短程穿梭运送
regenerate|新生， 再生， 起革新作用 vt. 使新生，重建，改革，革新
allocate|分配； 分派， 把…拨给
latent|潜在的， 隐伏的， 不易察觉的
terrific|极妙的； 极大的； 令人恐惧的
standpoint|立场， 观点
primary|首要的， 主要的； 基本的； 最初的， 初级的
pirate|非法盗印者，侵犯版权者；海盗 vt. 盗用， 非法盗印
stubborn|顽固的， 执拗的， 倔强的； 难对付的， 难于克服的
formulate|构想出， 规划； 系统地阐述
consume|消灭， 毁灭 vt. 消费；吃完，喝光
dome|圆屋顶， 穹顶
layer|层， 层次
alien|外国的，外国人的；陌生的；性质不同的，不相容的 n. 外国人， 外侨； 外星人
competence|能力， 胜任， 称职
fuse|熔合， 合并； 因保险丝熔断而中断工作 n. 保险丝，熔丝；导火线
elite|[总称] 上层人士， 掌权人物， 实力集团； [总称]出类拔萃的人， 精英
premium|高级的，优质的；售价高的 n. 保险金；额外费用，加付款；奖品，赠品；额外津贴
ornament|装饰品，点缀品；装饰，点缀 vt. 装饰， 点缀， 美化
assure|使确信； 确保， 向…保证
pretext|借口， 托辞
ivory|象牙； 象牙色， 乳白色
theme|主题， 题目
consult|请教； 查阅； 商议
solidarity|团结一致
tumble|跌倒，摔下，滚下；翻滚；暴跌；不由自主地卷入 n. 跌倒， 摔倒
gracious|亲切的，和蔼的；优美的；雅致的，雍容华贵的 int. 天哪!
smash|猛撞，猛冲 vt. 使粉碎，使打烂；狠打，猛击；使破灭，使失败 n. 破碎； 猛击， 猛撞； 轰动的演出， 巨大的成功
merely|仅仅， 只不过
appropriation|据为己有， 占有； 挪用； 拨款
contradiction|矛盾， 不一致； 否认， 反驳
wealth|财富； 财产； 丰富
henceforth|从今以后， 从此以后
wallet|皮夹子
survive|活下来，继续存在；幸免于 vt. 从中挺过来； 从…逃出； 比…活得长
desire|想要，渴望 n. 愿望， 欲望
initial|最初的，开始的 n. 首字母
efficient|效率高的； 有能力的
murmur|n&v. 小声说； 小声抱怨， 咕哝； 发出连续而低沉的声音
fury|狂怒， 暴怒； 狂暴， 狂烈
unify|使联合， 统一； 使相同， 使一致
muddy|泥泞的，沾满烂泥的；灰暗的，暗淡的；模糊的，糊涂的 vt. 使沾上烂泥； 使显得扑朔迷离
hound|猎犬 vt. 追逼， 烦恼， 纠缠
consistent|坚持的， 一贯的； 一致的， 符合的
dole|救济，救济金 vt. 发放， 发给
reverse|反向，倒转 adj. 反向的； 相反的； 颠倒的 vt. 撤销，废除；使完全相反，彻底转变；使反转，使次序颠倒 n. 相反情况，对立面；反面，背面，后面；损失，倒退
barren|贫瘠的， 荒芜的； 不结果实的， 不育的； 无益的， 没有结果的
eternal|永久的， 永世的； 无休止的； 永恒的， 永不改变的
permanent|永久的， 固定的
foster|收养的 vt. 收养，养育；培养，促进
barely|仅仅， 只不过， 几乎不
prevalent|流行的， 普遍的
cling|紧紧抓住； 黏着， 挨近； 依附， 依恋； 坚持， 墨守， 忠实于
incidence|发生率
clip|夹子，回形针，别针；弹夹，弹仓；剪，修剪；剪报，电影片断 vt. 夹住， 扣住； 剪， 修剪
beam|面露喜色； 定向发出， 播送 n. 梁，横梁；束，柱；笑容，喜色
compact|紧凑的，小巧的；坚实的 vt. 把…压实，使坚实['kɔmpækt] n. 契约， 合同
alliance|结盟； 联盟
invaluable|非常宝贵的， 极为贵重的， 无价的
fiction|小说； 虚构， 杜撰
doom|注定，命定 n. 厄运， 劫数
cucumber|黄瓜
aviation|航空， 航空学； 飞机制造业
pessimistic|悲观的
denote|意思是； 表示， 是…的标志
emphasis|强调； 重视； 重要性
interrupt|打断， 中止； 打扰
propagate|繁殖， 增殖； 传播， 宣传， 普及
feasible|可行的， 可能的
majesty|陛下； 雄伟， 壮丽； 庄严
flatter|向…谄媚， 奉承； 使满意， 使感到荣幸； 使显得好看， 使显得突出
potential|潜在的，可能的 n. 潜力， 潜能
necessitate|成为必要， 需要
orthodox|传统的； 正统的， 正宗的
accustomed|惯常的， 习惯的
combination|结合， 联合； 化合
obtain|通用， 流行； 存在 vt. 获得
statesman|国务活动家， 政治家
tack|平头钉，大头钉；行动方向，方针 vt. 用平头钉钉； 附加， 增补
gross|总的； 严重的； 粗俗的； 臃肿的
lounge|倚，躺；闲逛，闲荡 n. 休息厅， 休息室
porch|门廊
workshop|车间， 工场； 专题讨论会
format|设计，安排；格式，样式，版式 vt. 使格式化
sacrifice|n&v. 牺牲， 舍身； 献祭， 供奉； 祭品
illegal|不合法的， 非法的
corps|队， 部队； 一组
eclipse|食；消失，黯然失色 vt. 食， 遮掩光； 使暗淡， 使失色， 使相形见绌
formal|正式的； 礼仪上的
correlate|相关， 关联 vt. 使相互关联
soar|猛增， 剧增； 高飞， 升腾； 高涨； 高耸， 屹立
commute|乘公交车上下班，经常乘车往返于两地 vt. 减； 折合， 折偿； 上下班交通
sustain|保持， 使持续下去； 供养， 维持； 支持， 支撑； 经受， 遭受
critical|决定性的； 批评的
shepherd|牧羊人，羊倌 vt. 带领， 引导
outcry|大声疾呼， 呐喊； 强烈抗议
radiant|容光焕发的， 喜形于色的； 光芒四射的， 光辉灿烂的； 辐射的
principal|最重要的，主要的 n. 负责人， 校长； 资本， 本金； 主要演员， 主角
exceedingly|极端地， 非常
uphold|支持， 维护
exotic|外来的， 异国情调的； 奇异的
relief|轻松， 宽慰； 缓解， 减轻， 解除； 使得到调剂； 接替， 替下
boycott|n&vt. 抵制， 拒绝参与
dimension|尺寸， 尺度， 面积； 方面， 特点； 面积， 规模
deserve|应受， 值得
process|过程；制作方法；程序 vt. 加工， 办理
revenge|报复，报仇 vt. 为…报仇， 报…之仇
restore|恢复， 使恢复； 修复， 整修； 归还， 交还
subscribe|订阅，订购；同意，赞成 vt. 捐助， 赞助
distill|蒸馏， 用蒸馏法提取； 吸取， 提炼
alternative|两者选一的， 供选择的； 另类的 n. 替换物，选择；选择的自由
concentration|集中； 专注， 专心； 浓缩； 浓度
velocity|速度， 速率
encounter|遭遇，遇到 n. 遭遇
fellowship|伙伴关系， 交情， 友谊； 团体， 协会， 联谊会； 奖学金， 研究员职位
colleague|同事， 同僚
approve|赞成， 称许 vt. 赞成，称许；批准
interaction|相互作用
pedestrian|步行者， 行人
interfere|干涉， 干预， 妨碍
apartment|一套公寓房间
account|说明…的原因； 占… n. 记述；解释；账目
fitting|适合的， 恰当的 n. 设备，家具，日用器具；配件，附件，零件；试穿，试衣
stack|堆，垛 vt. 堆积， 堆放于
radioactive|放射性的， 有辐射能的
resent|对…表示愤恨， 怨恨
stride|大踏步走 n. 大步； 步法， 步态； 进展， 进步
ambiguous|引起歧义的， 模棱两可的， 含糊不清的
impulsive|冲动的
qualitative|性质的， 定性的
diverse|不一样的， 相异的； 多种多样的
crisp|脆的，鲜脆的；挺括的；清新的，干冷的；简明扼要的，利落的 n. 油炸土豆片
prime|首要的；最好的 n. 青春；全盛时期 vt. 使准备好
intellect|智力， 理解力； 才智非凡的人
preference|喜爱， 偏爱； 优先； 偏爱的事物
mild|温柔的； 温暖的； 轻微的
loyal|忠诚的， 忠心的
impact|影响， 作用， 冲击 n. [Im'pækt]
paralysis|麻痹， 瘫痪， 中风； 无能， 无力
court|法院， 法庭； 庭院； 宫廷； 球场
chapel|小教堂， 祈祷室
distort|变形 vt. 歪曲，曲解；扭曲，使变形
subsidiary|辅助的，次要的，附设的 n. 子公司， 附属机构
venture|冒险； 大胆行事 n. 风险投资，风险项目 vt. 拿…冒险；敢于
discern|看出， 察觉出； 识别， 认出
enthusiasm|热情， 热心， 热忱； 巨大兴趣
flexible|易弯曲的； 灵活的
domain|领域， 范围； 领地， 势力范围
census|人口普查， 统计
corpse|死尸， 尸体
willful|故意的， 特意的
attitude|态度， 看法； 姿势
relative|有关系的，相对的 n. 亲属， 亲戚
compare|比较， 对照； 把…比作
depict|描绘， 描述
hop|单足跳跃，单足跳行；齐足跳跃，齐足跳行 vt. 跳上 n. 蹦跳； 短程航行
characteristic|特有的，典型的 n. 特性
involvement|连累； 包含
pave|铺， 铺筑
integral|构成整体所必需的， 基本的
lubricate|使润滑
comet|彗星
deadline|最后期限
bully|恃强欺弱者 vt. 威吓， 欺负
chip|屑片， 碎片； 炸土豆条； 集成电路片， 集成块； 缺口， 瑕疵
medieval|中世纪的； 中古的
tanker|油轮
involve|使卷入， 牵涉； 包含， 含有
pistol|手枪
assemble|集合，召集 vt. 集合， 聚集； 装配
watertight|不透水的， 防水的； 严密的， 无懈可击的
transition|过渡， 转变
repel|使厌恶； 击退， 逐回， 驱除； 排斥
mutter|n&v. 轻声低语； 小声抱怨
series|一系列， 连续； 丛书， 连续剧
complicated|复杂的， 难懂的
junk|废旧物品，破烂 vt. 丢弃， 废弃
maximum|最大的； 最高的； 顶点的 n. 最大量；顶点
thrive|兴旺， 繁荣， 旺盛
imaginative|富有想象力的， 爱想象的
penguin|企鹅
represent|作为…的代表， 表示， 象征； 描绘， 表现
masterpiece|杰作
compete|比赛， 竞争， 对抗
tolerant|宽容的， 容忍的
dispatch|派遣，调遣，发送 n. 急件， 快信； 新闻报道； 派遣， 调遣
emergency|紧急情况， 突然事件
dim|昏暗的，朦胧的；模糊不清的 v. 变暗淡
paralyze|使瘫痪， 使麻痹； 使丧失作用； 使惊愕， 使呆若木鸡
interpersonal|人与人之间的， 关于人与人之间关系的
exemplary|可作楷模的， 典范的
faculty|才能， 能力； 系， 科； 全体教员
layoff|解雇； 裁员； 歇工期， 停工期
wretched|极不愉快的， 难受的， 可怜的； 令人苦恼的， 讨厌的； 拙劣的
absurd|荒谬的， 荒唐的
modesty|谦虚
considerate|考虑周到的， 体贴的， 体谅的
glamor|魅力， 诱惑力
clue|线索， 暗示， 提示
bracket|括号；等级段，档次；壁架，托架 vt. 把…置于括号内； 把…归入同一类
legal|法律的； 合法的
midst|中部； 中间； 当中
trait|特征， 特点， 特性
radius|半径， 半径范围
disintegration|破裂， 分裂； 瓦解
signal|显著的， 重大的 n. 信号，暗号；标志，表示 vt. 发信号；标志着
impair|损害， 损伤； 削弱
dolphin|海豚
sightseeing|观光， 游览
stray|走失，迷路；分心，走神；离题 adj. 迷路的，走失的；孤立的，零星的 n. 走失的家畜
planet|行星
exhaust|使筋疲力尽，用尽；详尽论述 n. 排气装置； 废气
thereafter|之后， 以后
soluble|可溶的； 可解决的
feast|尽情地吃， 宴饮； 参加宴会 n. 盛宴，筵席；节日
vision|想象力， 梦幻； 视力， 视觉
accompany|陪同， 伴随； 为…伴奏
armor|盔甲， 装甲； 保护物
acceptance|接受， 承认； 容忍
beneficial|有利的， 有益的
paradise|天堂， 乐园
tackle|对付，处理；与…交涉；阻截，擒抱 n. 阻截， 擒抱； 用具， 钓具； 辘轳， 滑车
reckon|认为， 估计； 指望， 盼望； 测算， 测量
confusion|困惑， 糊涂； 混淆； 骚乱
distract|转移， 使分心
hinge|以…为转移 n. 铰链 vt. 装铰链
virtual|实质上的， 事实上的， 实际上的
squeeze|压榨，挤 n. 榨取， 勒索
blank|空白的；茫然的，无表情的 n. 空白； 空白表格
additional|附加的， 追加的
worthy|有价值的， 值得的
primarily|首先， 主要地
telecommunications|通信， 电信
ferry|渡船 vt. 渡运
ignore|不顾， 不理； 忽视
hemisphere|地球的半球； 大脑半球
reception|招待会， 欢迎会； 接受， 接纳； 接待， 迎接； 接收效果
applaud|鼓掌，喝彩 vt. 向…鼓掌， 向…喝彩； 称赞， 赞许
outward|向外地 adj. 外面的，外表的
lunar|月的， 月球的
poetry|诗， 诗歌， 诗集
jury|陪审团， 评奖团
arrogant|傲慢的， 自大的
idiot|白痴； 傻子， 笨蛋
relay|接力赛；中继转播 vt. 传送， 传达， 转述； 中继转播
priest|神父， 牧师
monitor|班长；监视器，检测器；显示器 vt. 监听， 检测
solo|以独力，单独地 adj. 单独的，单独进行的 n. 独奏， 独唱， 独舞
tuition|教学， 讲授， 指导； 学费
permeate|弥漫， 遍布， 散布； 渗入， 渗透
utopian|乌托邦的； 理想的
schedule|时刻表，日程安排表；清单，明细表 vt. 安排， 排定
tame|驯服的，顺从的；沉闷的，乏味的 vt. 制服， 控制并利用； 驯化， 驯服
adjoin|贴近； 与…毗连
universe|宇宙， 世界； 领域， 范围
inherit|继承
overwhelming|势不可挡的， 压倒的； 巨大的
interpret|解释， 说明； 口译
peculiar|奇怪的， 古怪的； 特有的
idiom|习语， 成语； 风格， 特色
diplomat|外交官， 外交家； 有交际手腕的人， 圆滑的人
hug|紧抱在一起，互相拥抱 vt. 拥抱；紧抱，怀抱 n. 紧抱， 热烈拥抱
grant|授给物 vt. 授予， 给予
muscular|肌肉发达的， 强壮的； 肌肉的
sparkle|发光，闪耀，闪烁；活跃，焕发 n. 闪光， 闪耀， 闪烁； 活力， 生气
hum|哼曲子；发嗡嗡声 vt. 哼 n. 嗡嗡声， 营营声， 嘈杂声
staple|主要的； 经常需要的 n. 订书钉，U形钉；主食；主要产品 vt. 用订书钉订
discount|折扣 vt. 把…打折扣； 不全信； 漠视， 低估
construct|建造； 构思 n. 建筑物； 构想； 观念
royalty|王族； 版税
convert|转变， 转化； 改变
attempt|尝试， 试图， 努力
rivalry|竞争， 竞赛； 对抗
relish|享受，从…中获得乐趣 n. 享受， 滋味， 乐趣； 调味品
fluorescent|荧光的， 发荧光的
division|分， 分割； 部门， 科， 处； 除法
superficial|表面的， 肤浅的
executive|执行的；行政的 n. 执行者
navigation|航行， 航海， 航空； 导航， 领航
melt|融化； 溶化； 消散
stalk|高视阔步地走 n. 茎，梗，柄 vt. 悄悄地跟踪
whereas|然而， 但是， 尽管
pitch|投掷， 使猛然倒下； 表达， 定下特定程度； 定调； 架设， 搭， 扎； 颠簸 n. 球场；程度，强度；高度，高音；沥青
casualty|伤亡人员， 死伤者； 受害人， 损失的东西
gauge|测量仪表；厚度，直径；规格、尺寸 vt. 估计， 判断； 计量， 度量
oriental|东方的； 东方人的； 东方文化的
electrical|电的； 电气科学的
stall|熄火； 拖延， 推迟 n. 货摊；
protest|['prəutest] n. 抗议， 反对
sensitive|敏感的， 灵敏的； 神经过敏的， 容易生气的； 易受伤害的
classification|分类， 分级， 分类法； 类别， 级别
brew|冲泡；酝酿，行将发生 vt. 酿造；冲泡 n. 冲泡的饮料
vacant|空的， 未被占用的； 空缺的； 茫然的， 空虚的
menace|具有危险性的人；威胁，威吓 vt. 威胁， 威吓
afford|担负得起； 提供
invalid|无效的，作废的；无可靠根据的，站不住脚的 n. 病弱者， 残疾者
curse|诅咒，咒骂，天谴 n. 祸害， 祸根； 咒骂， 诅咒， 咒语
legitimate|合情合理的；合理的，法律认可的 vt. 使合法
appease|平息， 抚慰； 姑息
sieve|筛子，漏勺 vt. 筛， 滤
whereby|凭此； 借以； 由于
evaluate|评价， 估…的价
status|地位， 身份； 情形， 状况
machinery|机器， 机械
shield|防护物，护罩；盾 vt. 保护， 防护
skip|跳，蹦跳；跳绳 vt. 跳过，略过，漏过 n. 跳， 蹦跳
instantaneous|瞬间的， 即刻的
phenomenon|现象， 迹象； 非凡的人
quarterly|按季度，一季一次 adj. 季度的，每季一次的 n. 季刊
notify|通知， 告知； 报告
bibliography|参考书目； 书目
stream|流出， 涌出 n. 河，溪流；一股，一串
recur|再发生， 重现
coalition|结合体， 同盟； 结合， 联合
generalize|概括， 归纳， 推断； 普及
accumulate|积累， 堆积
crime|罪， 罪行， 犯罪
dwarf|矮小的，发育不全的 n. 矮子，侏儒 vt. 使显得矮小， 使相形见绌
heave|举起，提起；扔；发出；起伏，隆起；呕吐，恶心 n. 举起， 升降
leisure|空闲时间； 悠闲
nourish|养育， 喂养， 滋养； 怀有， 增强
grease|油脂；润滑脂，润滑油 vt. 用油脂涂， 给…加润滑油
allege|断言， 宣称， 硬说
pilgrim|朝圣者
trigger|扳机；引起反应的行动 vt. 触发， 引起
assimilate|被吸收， 被消化； 被同化 vt. 吸收，消化；使同化
positive|确实的， 明确的； 积极的， 肯定的
segregate|使隔离， 使分开
addict|有瘾的人； 入迷的人 vt. 使成瘾， 使入迷
prospect|前景， 前途， 可能性； 景象， 景色； 可能成为主顾的人， 有希望的候选人
withhold|拒绝， 不给； 抑制， 制止
comparable|可比较的； 类似的； 比得上的
discreet|谨慎的， 慎重的， 审慎的
specialize|专攻，专门研究 vt. 使适应特殊目的， 使专用于
instance|例子， 实例， 事例
presumably|大概， 可能， 据推测
bonus|奖金， 红利； 额外给予的东西
recognition|认出， 识别； 承认， 确认， 认可； 赏识， 表彰， 报偿
banquet|宴会， 盛宴
thrill|非常兴奋， 非常激动 n. 兴奋，激动；引起激动的事物
aisle|过道， 通道
convene|开会，集合 vt. 召集
arrangement|整理， 排列； 安排； 准备工作
revenue|收入， 收益； 税收， 岁入
solution|解决； 解决办法； 溶液
monopoly|垄断， 专卖； 垄断物， 垄断商品， 专卖商品
opponent|对手； 敌手， 对抗者
accelerate|使加快， 使增速
supplementary|增补的， 补充的
grain|谷物， 谷粒， 颗粒； 少量， 微量
credit|信贷，赊欠；赞扬，荣誉；学分；信任 vt. 相信； 把…记入贷方； 把…归于
oxygen|氧， 氧气
intensive|加强的； 精耕细作的
alter|改变， 变更， 变动
combine|结合，联合；化合 n. 联合企业； 联合收割机
ideal|理想的，观念的，空想的 n. 理想， 理想的东西
occur|发生， 出现， 存在； 被想起， 被想到
illustrate|说明
hose|软管，水龙带 vt. 用软管淋浇
definitive|最可靠的， 权威性的； 决定性的
streak|飞跑，疾驶 n. 条纹，条痕；个性特征；一阵子，一连串 vt. 在…上加条纹
pressure|压，压强；压迫 vt. 对…施加压力， 迫使， 说服
dentist|牙科医生
brood|沉思，考虑；孵蛋 n. 一窝； 全体孩子
literacy|识字， 有文化， 读写能力
originate|起源于，来自，产生 vt. 创造， 创始， 开创
specialist|专家
background|出身背景， 经历； 背景资料； 背景， 底子
millionaire|百万富翁， 大富翁
transit|运输， 载运
adolescent|青春期的； 青少年的 n. 青少年
nonetheless|尽管如此， 依然， 然而
dispose|去掉， 销毁； 处理， 解决； 使倾向于
petty|小的， 琐碎的； 不重要的； 气量小的， 心胸狭窄的
glow|发光； 燃烧 n. 白热光；脸红；激情
sentiment|意见， 观点； 感情， 情绪
differentiation|区别
constitution|宪法， 章程； 组成； 设立
patent|专利的，受专利保护的 n. 专利，专利权 vt. 得到…的专利权
cocaine|可卡因， 古柯碱
groove|沟， 槽
abundance|大量， 丰富， 充足
racket|喧嚷， 吵闹； 敲诈， 勒索， 诈骗； 球拍
conceive|构想出， 设想； 怀孕 vt. 想出，认为；怀
sour|酸的；馊的，酸味的；脾气坏的 v. 变酸， 变馊； 变得乖戾
transform|使改观， 改革； 变换， 把…转换成
napkin|餐巾
reckless|鲁莽的， 不考虑后果的
paradox|似乎矛盾而正确的说法； 自相矛盾的人
magnitude|重要性， 重大； 巨大， 广大
justification|正当的理由， 借口
genuine|真的， 真正的； 真诚的
execution|死刑； 实行， 执行， 履行； 演奏， 表演
immune|免疫的， 有免疫力的， 不受影响的； 免除的， 豁免的
brochure|小册子
stern|严厉的，严格的，严峻的 n. 船尾
rotary|旋转的， 转动的
compound|复合的，化合的 n. 化合物，复合物；复合词 vt. 使恶化， 加重； 使化合， 使合成
dub|给…起绰号， 把…称为； 为配音， 译制
masculine|男性的， 男子的； 男子气的
extraordinary|非同寻常的， 特别的
witness|证据；目击者，证人 vt. 目击； 为…作证， 证明
conventional|普通的； 习惯的， 常规的； 因循守旧的
regulation|规章， 规则； 管理， 控制， 调节
conform|遵守， 适应； 顺从； 相似， 一致， 符合
circulation|循环， 流通； 流传， 传播， 发行； 发行量； 流通
authentic|真的， 真正的； 可靠的， 可信的
mere|仅仅的， 纯粹的
accommodation|住处， 膳宿
evident|明显的， 明白的
suburb|郊区， 郊外， 近郊
pumpkin|南瓜
annoy|使恼怒； 打搅
profess|表示， 承认； 宣称信仰
psychological|心理的
credible|可信的， 可靠的
empirical|以经验为依据的， 经验主义的， 经验的
commit|犯， 干； 使承诺； 把…托付给； 调拨…供使用， 拨出
curb|控制，约束 n. 控制， 约束； 路缘
crash|倒下，坠落；发出撞击声；垮台，破产 vt. 碰撞，砸碎；冲，闯 n. 碰撞； 破裂声
character|性格， 特性； 性质； 人物， 角色； 符号， 字
reflect|反映， 显示； 反射， 映现； 深思， 考虑， 反省
outfit|全套服装； 一组人； 全套装备， 全套工具
contribution|贡献； 促成作用； 捐款， 捐献物； 稿件
ongoing|持续的， 继续的
massacre|大规模屠杀，残杀；彻底击败 n. 大屠杀， 残杀； 惨败
reassure|使放心
bang|猛击， 猛撞； 发出砰的一声， 砰砰地响； 砰地敲 n. 巨响；枪声；猛击
magnetic|磁的； 有吸引力的
cholesterol|胆固醇
orbit|轨道 vt. 作轨道运行
band|乐队；群，伙；带；条纹；波段 vt. 用带绑扎
negligible|可忽略不计的， 微不足道的
setback|挫折， 倒退， 失败
resident|居住的， 定居的； 住校的， 住院的 n. 居民，定居者；住院医生
symbolic|符号的； 象征性的
distinguish|区别， 辨别， 识别； 使杰出； 使著名
mall|购物中心
module|组件， 模块， 模件； 舱
howl|n&vi. 嗥叫； 呼啸； 吼叫， 哀号
execute|将…处死； 实施
substantial|可观的， 大量的； 物质的， 坚固的； 实质的， 真实的
benefit|得益 n. 利益，恩惠；救济金，保险金，津贴 vt. 有益于
booth|小房间， 公用电话亭， 岗亭； 售货棚， 货摊
enthusiastic|满腔热情的， 热心的， 极感兴趣的
disastrous|灾难性的， 造成灾害的； 极坏的， 很糟的
unique|唯一的， 独一无二的； 极不寻常的， 极好的
processing|处理
boost|推动， 促进， 激励； 替…做广告， 宣扬； 提高， 使增长 n. 提高，增长；推动，激励
impulse|冲动， 一时的念头； 推动， 驱使； 脉冲
sober|未醉的，有节制的；严肃的，持重的；素淡的，暗淡的 v. 醒酒， 清醒
crystallize|结晶； 变得清晰而明确； 使具体化
religious|宗教的； 笃信宗教的， 虔诚的
infectious|传染的， 有传染性的； 有感染力的
shelter|掩蔽， 躲避， 庇护 n. 掩蔽处，躲避处；掩蔽，保护
prominent|突出的， 杰出的； 突起的； 凸出的
expel|把…除名， 把…开除； 驱逐， 赶走， 放逐； 排出， 喷出
superiority|优越， 优等
outset|开始， 开端
latitude|纬度； 纬度地区； 回旋余地， 自由
scan|细看，审视，浏览 n. 扫描
association|协会， 团体； 联合， 交往
fundamental|基础的，基本的 n. 基本原则
eliminate|消灭， 消除， 排除； 淘汰
cute|漂亮的， 娇小可爱的； 聪明伶俐的， 精明的
entitle|给…权利； 给题名
outline|提纲，要点；外形；略图 vt. 概述； 描…的外形
partition|分隔物，隔墙；分割，划分 vt. 隔开； 分割， 瓜分
nominal|名义上的， 有名无实的； 很少的， 象征性的； 名词性的
excess|过量的， 额外的 n. 超越，过量，过度['3ks3s]
glance|看一下 n. 一瞥
perspective|视角， 观点； 远景， 景观； 透视画法， 透视图
galaxy|星系； 银河系， 银河； 一群
equality|等同； 平等； 相等
destruction|破坏， 毁灭； 消灭
rebellion|反叛， 反抗
expression|词语； 表达， 表情
reaction|反应， 反作用
accordance|一致， 和谐， 符合
weary|厌烦， 不耐烦 adj. 疲劳的，疲倦的；使人疲劳的，令人厌倦的
appeal|求助，诉请；要求；有吸引力 vt. 控诉，移交上级法院审理 n. 吸引力； 呼吁； 上诉
swamp|沼泽 vt. 淹没， 浸没； 难倒， 压倒
entrepreneur|企业家
dedicate|题献词于上； 把献给， 把用于
peninsula|半岛
extensive|广阔的； 广泛的
residential|居住的， 住宅的； 寄宿的， 住在住所的
definitely|一定地， 明确地
stab|n&v. 刺， 戳
abandon|离弃， 丢弃； 遗弃； 抛弃； 放弃
collaboration|合作， 协作； 勾结
inspire|鼓舞； 给…以灵感
impart|告知， 透露； 赋予， 给予
bureaucracy|官僚主义， 官僚作风； 官僚机构； 官僚制度； 官僚
household|家庭的， 家喻户晓的 n. 家庭，户；家务
glide|滑行， 滑动； 滑翔
adverse|不利的， 有害的
bulletin|简明新闻， 最新消息； 公告， 布告， 公报； 学报， 期刊
devote|将…奉献给， 把…专用
junction|联结点， 交叉点， 枢纽
crumble|崩溃， 瓦解 vt. 弄碎
agent|代理人， 代理商； 政府代表； 动因， 原因； 剂
abortion|流产， 堕胎
salvation|拯救， 解救； 解救措施
instinct|本能； 直觉， 生性
cannon|加农炮， 大炮， 火炮
invest|投资， 投入； 授予
reputation|名誉， 名气， 名声
project|伸出； 投射； 放映 n. 方案， 计划； 课题， 项目； 工程
shrug|n&v. 耸肩
arena|表演场地， 竞技场； 活动场所
independence|独立； 自主； 自立
shrub|灌木
presentation|提供， 显示； 外观， 图像； 授予， 赠送； 报告， 介绍； 表演
nominate|提名， 任命； 推荐， 指定
loom|阴森地逼近， 隐现； 即将来临 n. 织布机
stationary|固定的， 静止不动的
restrain|阻止， 控制； 抑制， 遏制
awkward|笨拙的， 尴尬的； 难操纵的， 使用不便的； 不灵巧的
ruin|毁坏 n. 毁灭；废墟
beforehand|预先， 事先
formidable|可怕的， 令人敬畏的； 难以克服的， 难对付的
impatient|不耐烦的， 急躁的； 热切的， 急切的
invert|使倒转， 使倒置， 使颠倒
cradle|摇篮；策源地，发源地 vt. 轻轻地抱， 捧
discrete|分离的， 不相关联的
assurance|把握， 信心； 保证， 表示保证的话； 保险
psychiatrist|精神科医生， 精神病专家
squad|班， 小队， 小组
disrupt|使中断； 扰乱
scar|留下伤痕 n. 伤疤，伤痕；创伤
sergeant|中士， 警官
vital|生死攸关的， 极其重要的； 生命的， 有生命力的
eccentric|古怪的，怪癖的，异乎寻常的 n. 古怪的人， 怪癖的人
conflict|冲突， 抵触 n. 冲突， 抵触； 争论； 战斗， 战争
appliance|用具， 器具， 器械
alloy|合金 vt. 将…铸成合金
delusion|欺骗； 哄骗
mass|大量的，大规模的 v. 聚集， 集中 n. 众多，大量；团，块，堆；群众；质量
detect|察觉， 发觉； 侦查出
update|更新；使现代化 n. 最新信息
renaissance|文艺复兴， 文艺复兴时期； 复兴， 再生
poisonous|有毒的； 恶毒的
condemn|谴责， 指责； 判…刑， 宣告…有罪
assistance|协助， 援助
auction|n&vt. 拍卖
propel|推进， 推动； 激励， 驱使
admit|承认 vt. 承认，供认；准许…进入
uneven|不平坦的， 不平滑的； 不一致的， 不相等的
definition|定义， 释义， 定界； 清晰， 鲜明
mansion|大厦， 宅邸
mask|面具，面罩，口罩；伪装 vt. 遮盖， 掩饰
patrol|巡逻，巡查 n. 巡逻， 巡查； 巡逻兵， 巡逻队
nickel|镍； 五分镍币， 五分钱
patron|资助人， 赞助人； 老主顾， 顾客
entail|使承担； 使成为必要， 需要
inferior|下等的，劣等的 n. 下级， 下属
apply|应用，实施，使用；适用；申请，请求 vt. 涂， 敷， 施
propaganda|宣传
overlook|忽视； 宽恕； 俯瞰
refuge|庇护所， 避难处； 庇护
dramatic|引人注目的， 激动人心的； 戏剧的
incredible|不能相信的， 不可信的， 难以置信的； 惊人的
certainty|必然的事， 确定的事实； 确信， 确实
corrode|腐蚀， 侵蚀
spine|脊柱， 脊椎； 刺， 刺毛； 书脊
commend|称赞， 表扬； 推荐
parasite|寄生生物； 寄生虫
artificial|人工的， 人为的； 矫揉造作的； 模拟的
deficiency|缺乏， 不足； 缺点， 缺陷
imaginary|想象中的， 假想的
formula|公式， 式； 原则， 方案； 配方
disgust|n&vt. 厌恶， 憎恶
transcend|超出， 超越范围
tribute|颂词， 称赞， 礼物； 贡品
mob|暴民，乌合之众 vt. 成群围住， 聚众袭击
subordinate|下级的，级别低的；次要的，从属的 n. 部属， 下级 vt. 使处于次要地位， 使从属于
trend|伸向，倾向 n. 倾向
achievement|完成； 成就， 成绩
sturdy|强壮的， 结实的， 坚固的； 坚定的， 坚强的
desirable|吸引人的， 可取的
consist|由…组成； 在于； 一致
reliable|可靠的， 可依赖的
compatible|兼容的； 能和睦相处的， 合得来的
incentive|刺激， 鼓励
critic|批评家， 爱挑剔的人
preliminary|预备的，初步的 n. 初步做法， 起始行为
obstacle|障碍， 障碍物； 妨害
profession|职业； 公开表示
van|大篷车， 运货车
dizzy|头晕目眩的，眩晕的；头晕的 vt. 令人发晕
resemblance|相似， 形似
exceptional|优越的， 杰出的； 例外的， 独特的， 异常的
constitute|组成， 形成； 设立； 任命
cherish|珍爱， 珍视； 爱护， 抚育； 抱有， 怀有
discrepancy|不符合， 不一致
spectrum|谱， 光谱， 频谱； 范围， 幅度， 系列
convince|使确信， 使信服， 说服
prolong|延长， 拉长， 拖延
missionary|传教士
terminate|停止， 终止
valve|阀， 活门； 瓣膜， 活瓣
refund|退款 vt. 退还
remnant|残留部分
internal|内的， 国内的； 内心的
literary|文学的； 文人的， 书卷气的
classical|古典的， 经典的
privilege|特权； 优惠
substitute|代替人，代用品 vt. 用…代替
mortgage|抵押，抵押借款 vt. 抵押
blaze|熊熊燃烧，着火；发光，放光彩；迸发，爆发 n. 火焰， 烈火； 光辉， 强烈的光； 迸发， 爆发； 灿烂， 炫耀
moreover|而且， 再者， 此外
scatter|撒， 散播； 使散开， 驱散
violate|违反， 违背； 亵渎； 侵犯， 妨碍
federal|联邦的， 联盟的
verify|证实， 查证， 证明
excursion|远足， 短途旅行
inaugurate|开始， 开展； 为…举行就职典礼； 为…举行开幕式， 为…举行落成仪式
undergo|经历； 经受， 忍受
reward|报答，奖赏；报酬，酬金 vt. 报答， 酬谢， 奖励
graze|吃青草 vt. 放牧；擦伤；擦过，掠过 n. 擦破
coupon|礼券， 优惠券； 配给券， 票证
multitude|大量， 许多； 大众， 民众
inhabit|居住于， 栖居于
siege|包围， 围困
abstract|抽象的，抽象派的 n. 摘要，梗概；抽象派艺术作品
agenda|议程
degenerate|衰退，堕落，蜕化 adj. 衰退的，堕落的 n. 堕落者
nurture|n&vt. 养育， 培育， 滋养
destructive|破坏的， 毁灭的
appearance|出现， 来到； 外观
culture|文化， 文明； 教养； 培养； 培养菌
paternity|父权， 父子关系
hasty|草率的， 轻率的； 急速的， 匆忙的， 仓促完成的
anonymous|无名的， 不具名的； 匿名的； 无特色的， 无个性特征的
fake|假的，伪造的 n. 假货；骗子 vt. 伪造， 捏造； 伪装
span|跨距，一段时间 vt. 持续， 贯穿， 包括； 横跨， 跨越
escort|护卫者，护送者 vt. 护送， 护卫
bizarre|奇形怪状的， 怪诞的
existence|存在， 实在； 生存
ascribe|把…归因于， 把…归属于
threshold|门槛， 门口； 入门， 开端， 起始点
float|浮动， 漂浮， 飘动
minority|少数； 少数民族
axis|轴， 轴线， 中心线； 坐标轴， 基准线
pole|杆； 极， 磁极， 电极
preferable|更可取的， 更好的， 更合意的
reference|提到， 论及； 参考， 查阅； 引文； 参考书目； 证明书， 推荐信
spite|恶意，怨恨；不顾 vt. 刁难， 欺侮
defendant|被告
arrange|安排， 准备； 整理
olive|橄榄， 橄榄树
coarse|粗的， 粗糙的； 粗劣的； 粗俗的
exaggerate|夸大， 夸张
streamline|使成流线型； 精简， 使效率更高
imply|暗示， 意指
offset|补偿， 抵消
commitment|承诺， 许诺， 保证； 信奉， 献身； 承担的义务
cavity|洞， 穴， 凹处； 龋洞
coward|胆小鬼， 懦夫
fossil|化石； 食古不化的人， 老顽固
poke|伸出，突出 vt. 戳，捅；用…戳，把…戳向；伸出，突出 n. 戳， 捅
rejection|拒绝
fixture|固定装置； 固定在某位置的人
manufacture|制造，加工 n. 制造， 制造业
collision|碰撞； 冲突， 抵触
sequence|连续， 接续， 一连串； 次序， 顺序
recruit|招募， 吸收
provision|供应； 准备， 预备； 条款， 规定； 给养， 口粮
calorie|大卡； 卡
slogan|标语， 口号； 广告语
invariably|不变地， 始终如一地， 总是
commence|开始
tract|传单， 小册子； 大片
configuration|配置， 布局， 构造
mercury|水银， 汞
frequent|时常发生的， 常见的
chunk|厚片， 大块； 相当大的部分
interact|相互作用， 相互影响
commonplace|普通的，平庸的 n. 寻常的事物， 平庸的东西
aggregate|总计的， 合计的 n. 总数，合计 vt. 总计达， 合计； 使聚集， 使积聚
seemingly|表面上， 看上去
attendant|伴随的， 随之产生的 n. 服务人员，侍者，随从
array|展示；陈列，一系列；排列，队形；衣服，盛装；
parameter|界限， 范围； 参数
extinct|灭绝的， 绝种的； 不再活跃的， 熄灭了的， 已废弃的
discriminate|区别， 辨别； 有差别地对待， 歧视
degrade|降低…的身份， 有辱…的人格； 使降解， 使退化
opaque|不透明的， 不透光的； 难理解的， 晦涩的
repay|归还； 报答
monetary|钱的， 货币的； 金融的
grave|严重的， 严肃的 n. 坟墓
advantage|优点， 优势； 好处
controversy|争论， 辩论
command|n&vt. 命令， 指挥； 控制
compulsory|必须做的， 强制性的； 必修的
performance|演出； 履行， 执行， 完成； 工作情况， 表现， 工作性能
serial|连续的， 顺序排列的 n. 连续剧，连载故事
anticipate|预料， 预期， 期望； 先于…行动， 提前使用
detach|拆卸； 使分开， 使分离
slash|砍；大幅度削减 n. 砍， 砍痕； 斜线号
fabricate|捏造， 伪造， 编造； 建造
comic|喜剧的，滑稽的 n. 连环漫画； 喜剧演员
perfection|完美， 完善
vague|不明确的； 含糊的； 暧昧的
pope|教皇， 罗马主教
exception|例外， 除外
ego|自我， 自己， 自尊
urge|鼓励；推进，催促；竭力主张，强烈要求 n. 冲动， 强烈的欲望
spouse|配偶
score|得分，比数，成绩；二十 vt. 分， 给…打分； 画线于； 获胜
isle|小岛， 岛
enclosure|四周有篱笆的场地， 围场； 附件
graduate|研究生的 v. 毕业 n. 毕业生；研究生
famine|饥荒； 严重的缺乏
quota|定额， 限额， 配额
unanimous|全体一致的， 一致同意的
scorn|轻蔑，鄙视 vt. 轻蔑， 鄙视； 拒绝， 不屑
thermal|热的， 由热造成的； 保暖的
sulfur|硫
visual|看的， 视觉的
terrain|地形， 地势
grief|悲伤， 悲痛； 悲伤的事， 悲痛的缘由
rap|说唱 vt. 敲击，急敲；突然厉声说出；责备，训斥 n. 敲击， 急敲
upgrade|提升，使升级 n. 向上的斜坡
instruct|教， 指示； 通知； 教育
appendix|阑尾； 附录
virtually|事实上， 实质上
agreeable|令人愉快的， 惬意的； 同意的， 乐意的
economy|经济； 节约， 节省
community|社区， 社会， 公社； 团体， 界； 群落
version|译文， 说法， 改写本
sprinkle|撒，洒 n. 少量， 少数
bronze|青铜， 青铜色， 古铜色； 青铜制品， 铜牌
conception|思想， 观念， 概念； 构想， 设想； 怀孕
municipal|市的， 市政的
detain|拘留， 扣留； 留住， 耽搁
institute|研究所，学院 vt. 建立， 设立
endure|忍受， 容忍； 持久， 持续
detail|细节，枝节；零件 vt. 详细说明
subculture|亚文化
appropriate|适当的，恰当的 vt. 私吞； 拨款供专用
criterion|标准， 准则
essence|本质， 实质， 要素； 精髓， 精华
pore|仔细阅读， 审视 n. 毛孔，细孔
utility|效用， 有用
manual|用手的，手工做的 n. 手册， 指南
maneuver|设法变动位置； 用策略， 耍花招 n. 谨慎而熟练的动作；策略，花招；演习 vt. 设法使变动位置；操纵，控制
symphony|交响乐， 交响曲； 和谐， 协调
eloquent|雄辩的， 口才流利的， 有说服力的； 明白显示出的
optimistic|乐观的， 乐观主义的
dual|双的， 两重的
submarine|水底的， 海底的 n. 潜水艇
aspect|方面； 朝向、 方向； 样子， 外表
aggressive|侵略的， 好斗的； 敢作敢为的； 有进取心的
stump|脚步沉重地走 n. 树桩；残根，残余部分 vt. 把…难住，使为难；在…做巡回演说
behavior|行为， 举止， 表现
federation|联合会； 联邦
minimize|使减少到最低限度； 极力贬低， 对…作最低估计
descend|下来，下降 vt. 走下， 爬下
signify|有重要性 vt. 表示…的意思，意味，预示
logical|逻辑的， 合乎常理的
reconciliation|和解， 调和
weird|古怪的， 离奇的； 怪诞的， 神秘而可怕的
characterize|成为…的特征， 以…为特征； 描绘的特性， 描述
descent|下降， 下倾； 斜坡， 坡道； 血统， 世系
ridiculous|荒谬的， 可笑的
turbulent|动荡的， 混乱的； 汹涌的， 狂暴的
overt|公开的， 不隐蔽的
refute|驳斥， 驳倒
precedent|先例， 范例； 【法】 判例； 惯例
severe|严重的； 严厉的， 严格的； 严峻的， 艰难的； 朴素的， 不加装饰的
emerge|出现， 涌现， 冒出
exemplify|是…的典型； 例示， 举例证明
lease|租约，租契 vt. 出租； 租得， 租有
exploit|剥削； 利用； 开拓 n. 业绩， 功绩
slap|掴，掌击，拍；啪的一声放 n. 掴， 掌击， 拍
anniversary|周年
register|登记， 注册； 指示， 自动记下； 表示， 表达； 注意到， 记住； 把挂号 n. 登记，注册；登记表，注册簿
communicate|通讯， 交际， 交流； 连接， 相通； 传达， 传播； 传染
evidence|根据， 证据； 证人
jerk|猝然一动，猛拉 n. 急推， 急拉， 急扭
fling|扔，掷；使扑，使投身 n. 尽情欢乐的一阵， 一时的放纵
stun|使震惊， 使目瞪口呆； 把…打昏， 使昏迷
acid|酸的， 酸性的； 尖刻的， 刻薄的 n. 酸
autonomy|自治， 自治权； 人身自由， 自主权
transmission|传播， 发射； 传送， 传递； 传染
blush|n&vi. 脸红
dubious|怀疑的， 犹豫不决的， 无把握的； 有问题的； 靠不住的
intuition|直觉； 由直觉获知的信息
artillery|火炮， 大炮； 炮兵
educational|教育的， 教育性的
pose|造成，引起；提出，陈述；摆姿势；假装，冒充，装腔作势 n. 样子， 姿势
finite|有限的， 有限制的； 限定的
amend|修改，修订，改进 n. 赔罪， 赔偿
erupt|喷发， 喷出； 爆发， 突然发生
exquisite|精美的， 精致的； 敏锐的， 有高度鉴赏力的； 剧烈的， 感觉强烈的
collide|碰撞， 互撞； 冲突， 抵触
remedy|补救办法，纠正办法；药品，治疗法 vt. 补救， 纠正； 医治， 治疗
cardinal|最重要的； 基本的 n. 红衣主教；【数】基数
consent|n&vi. 同意， 赞成
insist|坚持； 坚持要求； 坚决认为
fusion|联合， 合并； 核聚变
volume|卷， 册， 书卷； 容积， 体积； 音量， 响度
mutual|相互的； 共同的
therefore|因此， 所以
exchange|n&vt. 交换； 交流； 兑换
indignant|愤怒的， 愤慨的， 义愤的
hesitate|犹豫， 踌躇， 含糊； 不情愿
decimal|十进位的 n. 小数
cynical|愤世嫉俗的， 怀疑的
ventilate|使通风； 把…公开， 公开讨论
scoop|舀出； 抢在之前报道新闻 n. 勺子；抢先报道的新闻
companion|同伴， 共事者； 伴侣
culminate|告终
breakdown|垮台， 破裂； 衰竭， 衰弱； 损坏， 故障； 明细， 清单
directory|人名地址录； 工商行名录； 号码簿
behave|表现，举止；运转，做出反应 vt. 检点自己的行为
accomplish|达到， 完成
strand|股，缕；一个组成部分 vt. 使搁浅
constituent|组成的， 构成的 n. 选民，选区居民；成分，组成；配料
engine|引擎， 发动机； 机车
irritate|使恼怒， 使烦躁； 使不适， 使疼痛
scope|范围； 余地， 机会
responsible|需负责任的， 承担责任的； 有责任感的， 负责可靠的； 责任重大的， 重要的
linen|日用织品； 亚麻织品， 亚麻布
expectancy|预料； 期待； 盼望
illuminate|照明， 照亮； 阐明， 启发
liner|衬里； 大客轮
identify|认出， 鉴定； 把…等同于
citizenship|公民的身份, 公民的职责和权力
label|标签，标记，符号 vt. 贴标签于； 把…称为
slippery|滑的； 狡猾的
forum|论坛， 讨论会； 专题讨论节目
contempt|轻视， 蔑视
modify|更改， 修改； 修饰
environment|环境； 外界； 围绕
clone|无性繁殖， 克隆 n. 无性繁殖系，克隆；复制品，翻版
betray|背叛， 出卖； 失信于， 辜负； 泄露； 暴露， 显露
progressive|前进的； 渐进的； 进行式的
pledge|保证，誓言 vt. 保证， 许诺
exempt|被免除的， 被豁免的 vt. 免除，豁免
deliberate|故意的， 蓄意的； 慎重的， 深思熟虑的 v. 仔细考虑， 思考
physiological|生理的， 生理学的
shaft|柄， 杆； 束， 光线； 轴； 竖井， 升降井
aesthetic|美学的， 审美的； 悦目的， 雅致的
atmosphere|大气， 空气； 气氛， 环境
decorate|装饰， 装潢， 修饰
electrician|电工， 电气技师
occupation|占领， 占据； 职业； 从事的活动， 消遣
tendency|趋向， 趋势， 倾向
release|n&vt. 释放， 排放； 解除， 解脱； 放开， 松开； 发布； 发行
caption|说明文字， 字幕
hardy|能吃苦耐劳的， 坚强的； 耐寒的
purify|使纯净， 提纯； 使纯洁
toll|敲 n. 过路费，过桥费；伤亡人数，损失
variation|变化， 变动， 变异； 变奏
moral|道德的，有道德的 n. 品行， 道德规范； 寓意
rig|操纵，垄断；给装配帆及索具；用临时替代材料迅速搭起 n. 船桅的装置， 成套器械
eject|驱逐， 逐出； 喷射， 排出； 弹出
defect|变节， 叛变 n. 缺点，缺陷，欠缺[dI'fekt]
reinforce|增强， 加强， 增援
casual|偶然的； 非正式的； 临时的， 不定期的； 漠不关心的， 冷淡的
slack|懈怠， 懒散 adj. 懈怠的，马虎的；萧条的，清淡的，不活跃的；松的 n. 松弛部分；宽松裤
rim|边，缘 vt. 环绕边缘
property|财产， 所有物； 房产； 物业； 性质， 性能
rip|扯破，撕坏 n. 裂口， 裂缝
outbreak|爆发， 突然发生
manipulate|操纵， 控制； 影响； 操作， 使用
similar|相似的， 类似的
contradict|反驳， 否认…的真实性； 与…发生矛盾， 与…抵触
melody|旋律， 曲调； 悦耳的音乐
likelihood|可能， 可能性
converge|会合， 互相靠拢； 聚集， 集中； 趋近
compose|组成， 构成； 创作， 为…谱曲； 使平静， 使镇静
catholic|[C-]天主教的；普遍的，广泛的 n. [C-]天主教徒
partial|部分的； 不公平的； 偏爱的， 偏袒的
aid|帮助，救护；助手，辅助手段 vt. 帮助， 援助
supersonic|超声的， 超音速的
optimism|乐观， 乐观主义
confident|确信的， 肯定的； 自信的
retain|保留， 保持
drastic|严厉的， 极端的； 激烈的， 迅猛的
epoch|时期， 时代
saleable|适合销售的
crew|全体船员； 一队工作人员
manufacturer|制造商， 制造厂
defeat|n&vt. 战胜， 挫败
valid|有效的， 正当的； 有根据的， 有理的
inertia|不活动， 惰性； 惯性
encourage|鼓励， 怂恿； 促进， 助长， 激发
vacuum|收集； 用真空吸尘器打扫 n. 真空；真空吸尘器
extravagant|奢侈的； 过度的， 过分的， 放肆的
accommodate|容纳； 向…提供住处； 使适应， 顺应
bubble|冒泡， 起泡， 沸腾 n. 泡，泡沫，水泡，气泡；幻想的计划
morality|道德， 道德性； 德行， 品行； 道德观， 道德规则
yield|出产；让出，放弃；屈服，顺从；倒塌，垮掉 n. 产量
electronic|电子的 n. 电子学； 电子设备
transplant|移栽，移种；移植；使迁移，使移居 n. 移植
terrace|排屋；地坪，草坪；
deficit|赤字， 亏空， 亏损
sacred|神圣的； 宗教的； 神圣不可侵犯的
cathedral|大教堂
elegant|优美的， 文雅的， 讲究的； 简练的， 简洁的
synthesis|综合； 合成
incidentally|顺便提及地， 顺便提一句
polar|地极的， 近地极的； 磁极的； 正好相反的， 截然对立的
shark|鲨鱼； 勒索者， 诈骗者， 放高利贷的人
linger|继续逗留， 留恋徘徊， 继续存留； 缓慢消失
historian|历史学家， 史学工作者
cumulative|积累的， 渐增的
prototype|原型
overpass|天桥， 立交桥
species|种， 类
slip|滑跤，滑落，溜；下降，跌落；悄悄放进 n. 疏漏， 差错
temperament|气质， 性格
cite|引用， 引证； 传唤， 传讯； 表彰， 嘉奖
acquaintance|认识， 了解； 熟人
moan|呻吟，呜咽；抱怨，发牢骚 vt. 抱怨 n. 呻吟声， 呜咽声； 怨声， 牢骚
quench|止； 扑灭
shed|脱落，脱去；流出，流下；发出，散发 n. 棚， 小屋， 货棚
spice|香料，调味品；趣味，情趣，风味 vt. 使增添趣味； 加香料于
rating|等级， 品级， 评定结果； 收视率， 收听率
assertive|断定的； 过分自信的
autonomous|自治的； 独立自主的
referee|当裁判 n. 裁判员；证明人，推荐人；仲裁者，调解者
aerial|飞机的，航空的；空中的，架空的 n. 天线
trial|试， 试验； 审判； 讨厌的人
perception|感知， 觉察； 认识， 观念， 看法
elapse|消逝， 过去
symmetry|对称； 匀称， 整齐
visualize|想象； 设想
reap|收割， 收获； 获得， 得到
insect|昆虫， 虫
presume|擅自行事 vt. 推测，假定，相信；冒昧，擅自；认定，推定
complement|补充，互为补充的东西；编制名额；装备定额；补语['kɒmplɪm3nt] vt. 补充， 与…相配
cable|缆，索，电缆，电报 vt. 给… 发电报， 用电报传送
nasty|令人讨厌的， 令人厌恶的； 难弄的， 困难的； 严重的， 恶劣的， 险恶的； 下流的， 道德败坏的
intense|强烈的； 紧张的； 认真的； 热情的
border|近似， 与…接壤 n. 边，边缘，边界 vt. 给…加上边，围；邻接
estate|地产， 房地产
articulate|善于表达的， 发音清晰的； 表达得清楚有力的 vt. 明确有力地表达； 清楚地吐， 清晰地发
adhere|黏附， 附着； 遵守； 坚持； 追随， 支持
expense|花费， 消费， 费用； 开支， 业务费用
traverse|横渡， 横越
rigorous|严密的， 缜密的； 严格的， 严厉的
yell|n&vi. 号叫， 叫喊
contemporary|现代的， 当代的； 同时代的
tribe|部落； 族
activate|使活动起来； 使开始作用
mobilize|动员起来 vt. 动员；调动，鼓动起
mock|嘲笑，嘲弄 adj. 模拟的， 演习的； 假的， 假装的 vt. 嘲笑，嘲弄；模仿
minibus|小型公共汽车
repetitive|重复的， 反复性的
gear|齿轮，传动装置，挡；用具，设备，衣服 vt. 使适应， 使适合
facilitate|使…变得容易， 使便利
precipitate|使突然发生； 猛然抛下； 使沉淀
endow|资助， 捐赠； 给予， 赋予， 认为…具有某种特质
financial|财政的， 金融的
respective|各自的， 各个的， 分别的
quiver|颤抖，发抖，抖动 n. 颤抖， 抖动， 颤声
slot|狭缝，狭槽；位置，空位 vt. 把…放入狭长开口中； 把…纳入其中， 使有位置
harden|变硬
rot|腐烂，腐朽 n. 腐烂， 腐朽
define|给…下定义， 限定
predict|预言， 预告， 预测
dictate|['dIkteIt] n. 口授； 命令， 规定， 要求
memorize|记住， 熟记
render|使得， 致使； 给予， 提供； 翻译
undermine|暗中破坏， 逐渐削弱； 侵蚀…的基础
subjective|主观的， 个人的
blossom|开花； 发展， 长成 n. 花
radical|根本的，基本的；激进的，激进派的 n. 激进分子
manifest|明显的，显然的，明了的 vt. 显示， 表明， 证明； 使显现， 使显露
blunt|钝的；率直的，直言不讳的 vt. 使迟钝； 使减弱； 使钝
endeavor|n&v. 努力， 尽力， 尝试
relieve|使轻松， 使宽慰； 缓解， 减轻， 解除； 使得到调剂； 接替， 替下
quartz|石英
air-conditioning|空调设备， 空调系统
adjacent|邻近的， 毗连的
employment|工作； 雇用； 使用
transport|运输 n. 运输， 运输工具
specific|特有的；明确的；具体的 n. 详情， 细节
analogy|比拟； 类比， 类推
application|申请， 申请书； 施用， 涂抹； 应用， 实施； 实用性
productive|多产的， 富饶的； 富有成效的
prune|修剪， 修整； 删除， 削减
engage|使从事于， 聘用； 吸引， 占用； 使订婚
chord|和弦， 和音； 弦， 心弦
semester|学期
strategy|战略， 策略
remainder|余下的部分， 剩下的人数
hypothesis|假设， 假说， 前提
revolve|旋转
collapse|n&vi. 倒坍， 瓦解； 崩溃， 突然失败
territory|领土， 版图； 领域
summon|召唤， 传唤； 鼓起， 振作； 召集， 召开
flare|闪耀，烧旺；突发，突然发怒 n. 闪光信号， 照明弹
accurate|准确的， 正确无误的
legend|传说， 传奇故事； 传奇人物
maintain|维持； 维修， 保养； 主张； 赡养
expertise|专门知识， 专长
bargain|讨价还价 n. 特价商品；协议，交易
erect|竖直的， 挺直的 vt. 建造，使竖立
professional|职业的，专业的，专门的 n. 自由职业者， 专业人员
nil|无， 零
identification|身份证明； 鉴定， 验明， 认出； 认同
migrant|移居者， 移民； 候鸟， 迁移动物
protein|蛋白质
annual|每年的，一年一次的 n. 年报， 年鉴； 一年生的植物
exclusive|奢华的，高级的；独有的；排斥的；不包括…的 n. 独家新闻
repertoire|全部节目
poverty|贫穷， 贫困
resort|求助，凭借，诉诸 n. 求助， 凭借， 诉诸； 求助的对象， 采用的手段； 常去之地， 胜地
testify|作证，证明；表明，说明 vt. 作证， 证明
pearl|珍珠； 珠状物； 珍品
conclusive|确实的； 最后的； 决定性的
margin|页边空白； 差数， 差额； 余地； 边缘
apt|易于…的， 有…倾向的； 恰当的， 适宜的； 聪明的， 反应敏捷的
remain|剩下，余留，保持；仍然是 n. 残余； 残骸； 遗迹
pregnancy|怀孕
shabby|破旧的， 衣衫褴褛的； 卑鄙的； 不公正的
toss|掷钱币来决定；翻来覆去 vt. 扔，抛，掷；猛抬；拌；掷；使摇动，使颠簸 n. 掷钱币来决定； 猛抬头
demand|要求，需要；询问 n. 要求， 需要
reel|摇摇晃晃地移动，蹒跚；眩晕，发昏 n. 卷轴，卷筒，卷盘 vt. 卷， 绕
pathetic|差劲的， 令人生厌的； 引起怜悯的， 可怜的， 可悲的
dissipate|消散，消失 vt. 使消散， 使消失； 浪费， 挥霍
flask|长颈瓶， 酒瓶， 烧瓶
accuse|指责， 归咎于
disturbance|扰乱， 打扰； 骚乱， 混乱； 心神不安， 烦恼
visceral|内脏的， 腑脏的； 出自内心的， 发自肺腑的
simultaneous|同时发生的， 同时存在的； 同步的， 一齐的
instructional|指导的， 教育的
guarantee|保证，担保物 vt. 保证， 担保
odor|气味
predecessor|前任， 前辈； 原有事物， 前身
acquire|取得， 获得； 学到
literal|照字面的， 原义的； 逐字的
notion|概念， 观念； 意图， 想法， 念头
default|不履行义务， 拖欠 n. 违约，拖欠；弃权；预设，缺省
arc|弧形； 弧； 电弧， 弧光
beverage|饮料
captive|被俘虏的，被捕获的 n. 俘虏
insane|极蠢的， 荒唐的； 精神病的， 精神失常的， 疯狂的
attribute|把…归因于 n. 属性
cemetery|墓地， 公墓
genetic|遗传的 n. [-s]遗传学
stitch|缝， 绣 n. 一针，线迹；缝法，针法，编结法；突然剧痛
triumph|成功 n. 凯旋，胜利
vice|罪恶， 恶习， 缺点； 虎钳
detection|察觉， 发觉； 侦查， 探测
bowel|肠； 内部， 深处
arouse|引起； 唤起， 唤醒
optimum|最合适的， 最优的， 最佳的
suppress|压制， 镇压； 禁止发表， 查禁； 抑制， 忍住； 阻止…的生长
pudding|布丁
wrinkle|起皱纹 n. 皱纹
consensus|一致， 一致同意
boring|令人厌烦的， 乏味的， 无聊的
classic|最优秀的，典型的，标准的；传统式样的，典雅的 n. 文学名著，经典作品，杰作；优秀的典范；
supervise|监督， 管理， 指导
gossip|传播流言蜚语 n. 流言蜚语；爱说长道短的人
describe|形容， 描写； 画出
dilemma|窘境， 困境
engagement|订婚， 婚约； 约会
wealthy|富的， 富裕的
slum|贫民窟
foam|起泡沫， 吐白沫 n. 泡沫；泡沫材料，泡沫状物
disregard|不理会，漠视 n. 忽视， 漠视
administration|管理； 管理部门， 行政机关； 实行， 执行
occasional|偶尔的， 间或发生的
dwell|居住
incorporate|包含； 加上， 吸收； 把…合并， 使并入
debate|n&v. 争论， 辩论
extinguish|熄灭， 扑灭； 使消亡， 使破灭
vulnerable|易受伤的， 脆弱的； 易受攻击的， 难防御的
furniture|家具
segment|部分， 片段； 瓣
counterpart|与对方地位相当的人， 与另一方作用相当的物
preach|布道， 说教 vt. 宣讲，布道；竭力鼓吹，宣传
flank|肋，肋腹，侧边；侧翼 vt. 位于…的侧面
donate|捐赠， 赠送
pendulum|摆， 钟摆； 摇摆不定的事态
defiance|违抗； 藐视
sovereign|拥有最高统治权的， 至高无上的； 具有独立主权的 n. 君主，元首
cater|满足需要， 迎合； 提供饮食及服务， 承办酒席
attractive|有吸引力的， 引起注意的
significant|相当数量的； 重要的， 意义重大的， 意味深长的
duplicate|完全一样的， 复制的 n. 完全一样的东西，复制品 vt. 复制， 复印； 重复
bleed|出血，流血；泌脂 vt. 勒索…的钱
rein|缰绳 vt. 勒缰使停步； 控制， 约束
decrease|减少 n. [dI'kriːs]
flutter|振翼，拍翅而飞；飘动，飘扬；快速跳动 n. 紧张， 激动不安
volunteer|自愿； 自愿提供； 志愿 n. 志愿者；志愿兵
overlap|部分重叠； 部分相同 n. 重叠， 重叠的部分
materialism|唯物主义
installment|分期付款， 分期交付； 部分
mourn|哀悼； 感到痛心
cane|手杖； 茎
trifle|嘲笑； 轻视 n. 琐事，小事，无价值的东西
migrate|迁徙， 移栖； 移居， 迁移
easter|复活节
submit|屈从， 听从； 忍受； 甘心 vt. 屈从，听从，服从；呈送，提交；主张，建议
novelty|新奇事物； 新奇， 新奇感， 新奇性； 新颖小巧而廉价的物品
occupy|占领； 占； 占有
string|线， 细绳； 一串， 一行
boom|激增， 繁荣， 迅速发展； 发出隆隆声 n. 激增，繁荣，迅速发展；隆隆声，嗡嗡声
absence|缺席， 不在； 缺席的时间， 外出期； 缺乏， 不存在
abolish|彻底废除， 废止
attract|吸引， 引起…注意
cautious|十分小心的， 谨慎的
snatch|一把抓住 vt. 夺，夺走，抢走；一下子拉，一把抓住；抓住机会做，抽空做 n. 片断
blink|眨眼睛；闪亮，闪烁 n. 眨眼睛； 一瞬间
summit|最高点， 峰顶； 最高级会议
perfume|香水，香料，香气 vt. 使充满芳香； 洒香水于
magnify|放大， 扩大； 夸大， 夸张
redundant|多余的， 过剩的
situated|位于…的， 坐落在…的； 处于…境地的
recession|衰退， 衰退期
doubtless|无疑地， 肯定地
negative|否定的，消极的；负的，阴性的 n. 负片， 底片； 负数
impose|把…强加； 征
statement|陈述， 声明； 结算单， 报表
trademark|商标， 牌号； 特征， 标记
factor|因素， 因子； 系数
analogous|类似的， 相似的； 可比拟的
substance|物质； 实质； 大意， 要旨； 根据， 理由
complexion|肤色， 面色； 局面； 性质
continuity|连续， 持续
sculpture|雕刻， 雕塑； 雕刻作品， 雕塑品
target|靶， 标的， 目标
momentum|动力， 冲力， 势头； 动量
wax|蜡，蜂蜡 vt. 给…上蜡
sensation|感觉能力； 感觉， 知觉； 轰动， 引起轰动的事件
urban|都市的， 住在都市的
furthermore|而且， 此外
timely|及时的， 适时的
cape|斗篷， 披肩； 海角， 岬
discard|丢弃， 抛弃， 遗弃
delicate|纤细的； 易碎的； 微妙的； 精美的
rebel|反叛， 造反； 反对， 不服从 n. 反叛分子，反对者
subsidy|津贴， 补助金
bounce|弹起，反弹，颠跳 n. 弹， 反弹
obscene|淫秽的， 下流的； 可憎的， 可恶的
tissue|组织； 薄绢， 薄纸， 手巾纸
thanksgiving|感恩节
proficiency|熟练， 精通
modest|谦虚的； 适中的； 羞怯的
cast|投，扔，抛；浇铸 n. 演员表， 全体演员； 石膏绷带； 铸型， 铸件； 投， 抛
vocational|职业的， 业务的
crush|压碎， 碾碎， 镇压
hatred|憎恶， 憎恨， 仇恨
slice|薄片，切片，部分 vt. 切， 削， 剁
electron|电子
embed|把…嵌入， 扎牢； 使深留脑中
incline|斜坡[In'klaIn] vt. 使倾斜
elevate|提升…的职位， 提高， 改善； 使情绪高昂； 举起， 使上升
designate|指派， 委任； 标出； 把…定名为
promising|有希望的， 有前途的
slick|圆滑的， 口齿伶俐的； 精巧的， 巧妙的， 灵巧的； 光滑的， 滑溜的
practicable|可行的， 适用的
item|条， 条款
counsel|律师，法律顾问；忠告，劝告 vt. 劝告， 提议
canvas|帆布； 帆布画布， 油画
superintendent|主管人， 监管人， 负责人； 警长
probability|可能性， 可能发生的事； 概率
contention|论点； 争论， 争辩
lofty|高傲的， 傲慢的； 崇高的， 高尚的； 高耸的， 极高的
explicit|详述的， 明确的， 明晰的； 直言的， 露骨的
rely|依靠， 依赖； 信赖， 指望
slide|滑；悄悄地移动 n. 滑动； 滑道， 滑面； 幻灯片
utilize|利用
sticky|黏性的， 胶粘的； 湿热的
prevail|流行， 盛行
excessive|过多的， 极度的
denial|否认； 拒绝， 拒绝给予
assault|攻击， 袭击
implicit|不言明的， 含蓄的； 内含的， 固有的； 无疑问的
intensify|增强， 加剧
feminine|女性的， 女子的； 女子气的
purity|纯净， 纯洁， 纯正
pattern|型，式样；模，模型 vt. 仿制， 使…仿效
settle|安排， 安放； 调停； 支付， 核算； 安家； 飞落， 停留； 安定
heighten|提高， 加强
vehicle|车辆， 机动车； 传播媒介， 工具， 手段
scrape|刮，擦；勉强过日子 n. 刮， 擦； 刮擦声
web|网； 网络； 错综复杂的事物
femininity|女性气质
plateau|高原； 稳定时期
tragic|悲惨的， 可悲的； 悲剧的
grin|咧嘴笑
grip|握紧，抓牢；吸引住…的注意力 n. 紧握
reliance|依靠， 依赖
explore|探险， 探索； 仔细查阅， 探究
display|n&vt. 陈列， 展览； 显示
electricity|电
climate|气候； 风土， 地带； 风气， 气氛
tentative|试探的， 试验的
disorder|混乱， 杂乱； 骚乱
aggravate|加重， 加剧， 使恶化； 激怒， 使恼火
criticize|批评， 评论， 非难
preside|主持，主管
economic|经济的；经济学的 n. 经济学； 经济状况
transistor|晶体管， 晶体管收音机
statistics|统计学； 统计表
grim|讨厌的， 糟糕的； 严厉的； 冷酷的， 无情的
giggle|咯咯笑， 傻笑
offspring|子女， 子孙， 后代； 崽
arrest|逮捕，拘留；停止，阻止；吸引 n. 逮捕， 拘留， 扣留
mature|成熟的，成年人的；深思熟虑的；到期的，应支付的 vt. 使成熟
alleviate|减轻； 缓解， 缓和
notification|通知， 告示； 通知书
overflow|满得外溢，外流，泛滥；充满，洋溢 vt. 淹没， 从…中溢出， 多得无法容纳 n. 容纳不下的物； 溢出， 满出； 溢流口， 溢流管
provoke|对…挑衅， 激怒； 激起， 引起
threaten|威胁， 恐吓； 预示快要来临； 构成威胁， 可能发生
enrich|充实， 使丰富； 使富裕， 使富有
foil|箔，金属薄片；陪衬，衬托 vt. 挫败， 使受挫折
strain|扭伤， 拉伤； 尽力使用， 紧张； 拉紧； 尽力 n. 拉紧；过劳，极度紧张；张力；扭伤，拉伤；旋律；品种，家系；气质，个性特点
negotiate|洽谈， 协商， 谈判； 顺利通过， 成功越过
cellar|地窖， 地下室； 酒窖
tangle|缠结，乱作一团 n. 乱糟糟的一堆， 混乱； 复杂的问题； 困惑
package|包裹，包装；一揽子交易 vt. 把…打包； 包装
intrigue|耍阴谋，施诡计 vt. 激起…的好奇心，迷住 n. 阴谋， 诡计， 密谋
orient|转向特定方向；适应[theO-] vt. 使适应，使熟悉情况；使朝向，以…为方向 n. 东方， 亚洲， 东半球
crisis|危机， 存亡之际； 关键阶段
handicap|缺陷；障碍，不利条件 vt. 妨碍， 使不利
survival|幸存； 幸存者； 残存物
shatter|碎裂 vt. 使粉碎，砸碎；使破灭；使震惊
plea|恳求， 请求； 抗辩， 答辩， 辩护； 借口， 托辞
persuasion|说服， 劝说； 信念， 信仰
keen|热心的； 激烈的； 敏锐的， 敏捷的
nutrition|营养
detective|侦探， 私人侦探
transfer|搬， 转移； 调动， 转学； 转让， 过户； 乘车， 转乘
veteran|经验丰富的 n. 老手；老兵
cereal|加工而成的谷类食物； 谷类植物， 谷物
esthetic|美学的， 审美的； 悦目的， 雅致的
indifferent|冷漠的， 不积极的； 一般的， 平平的
affection|感情； 爱， 爱慕
diversion|转移， 转向； 消遣， 娱乐； 临时绕行路
elementary|基本的， 初级的
eagle|鹰
solemn|庄严的， 隆重的； 严肃的
embarrass|使窘迫， 使为难
erroneous|错误的， 不正确的
option|选择， 选择权， 选择自由； 选择的事物， 选课
acute|严重的； 急性的； 灵敏的， 敏锐的； 精明的
limitation|限制， 限度； 局限
jog|n&v. 慢跑； 轻轻碰撞
terrify|使害怕， 使惊吓
handbook|手册， 便览
ascertain|弄清， 查明； 确定
crucial|至关重要的， 决定性的
contribute|捐献， 捐款； 投稿
insert|插入， 嵌入； 登载
faith|信任， 信心； 信仰， 信条
inspiration|灵感； 鼓舞人心的人
endurance|忍耐力； 持久， 耐久
highlight|强调，突出，使显著 n. 最精彩的部分， 最重要的事件
candidate|候选人， 投考者， 申请求职者
strive|努力， 奋斗， 力求
database|数据库
intelligible|可理解的， 明白易懂的， 清楚的
parallel|并列的，平行的；类似的；对应的；并联的 n. 可相比拟的事物，相似处；平行线，平行面；纬线 vt. 与…相似， 与… 相当， 比得上
reject|拒绝； 拒纳， 退回， 摈弃 n. 被拒货品， 不合格产品
hospitality|友好款待， 好客
sheer|垂直地，陡峭地 vi. 急转向， 偏离 adj. 完全的，十足的；陡峭的，垂直的；极薄的，透明的
imitation|模仿； 仿制， 伪制品； 赝品
compliment|赞美，恭维；致意，问候 vt. 赞美， 恭维
blunder|跌跌撞撞地走， 慌乱地走； 犯错误 n. 错误
breach|破坏，违反；破裂，不和；缺口，裂口 vt. 攻破， 在…造成缺口； 破坏， 违反
original|最初的；新颖的；原版的 n. 原件， 原作
comply|遵从， 依从， 服从
deviate|背离， 偏离
assignment|任务； 指定的作业； 分配， 指派
album|粘贴簿， 集邮簿， 相册
stimulus|促进； 刺激
electric|电的， 电动的
bewilder|使迷惑； 使难住
regiment|团；大量 vt. 严格地管制， 严密地编组
diminish|变少，变小，降低 vt. 减少， 减小， 降低
surpass|超过， 优于， 多于； 超过…的界限， 非…所能办到
various|各种各样的， 不同的
depression|抑郁， 沮丧； 不景气， 萧条； 洼地， 凹陷
affiliate|使隶属于 n. 附属机构， 分公司
unfold|展开， 打开； 显露， 展现
extent|广度； 范围； 程度
equivalent|相等的，等量的 n. 相等物， 等价物
sensational|轰动的， 耸人听闻的； 使人感动的， 非常好的
wedge|楔 vt. 楔入， 塞入
alienate|使疏远， 使不友好， 离间； 转让， 让渡
brink|边缘， 边沿
plague|瘟疫，鼠疫；灾难，祸患 vt. 使痛苦， 给…造成困难
perpetual|永久的， 永恒的， 长期的； 无休止的， 没完没了的
retrospect|回顾
fascinate|强烈地吸引， 迷住
colonial|殖民地的
warfare|战争； 斗争， 冲突
draft|草稿；汇票；征兵；通风 vt. 起草； 征募
complex|由许多部分组成的，复合的；复杂的，难懂的 n. 综合体， 集合体； 情结， 夸大的情绪反应
assumption|假定， 臆断； 担任， 承担
humidity|湿度， 潮湿， 湿气
rank|列入， 占特定等级 n. 军衔，职衔；地位，社会阶层；排，行列 vt. 把…分等，给…评定等级
pamphlet|小册子
preparatory|预备的
neglect|n&vt. 忽视， 忽略； 疏忽
addition|加， 加法； 附加物
vein|静脉， 血管； 叶脉； 纹理， 纹路； 方式， 风格
carve|切， 把…切碎； 雕刻， 刻
veil|面纱，面罩；遮盖物，掩饰物 vt. 掩盖， 掩饰
shrink|起皱； 收缩； 退缩， 畏缩
hierarchy|等级制度； 统治集团， 领导层
ancestor|祖宗， 祖先； 原型； 先驱
hazardous|危险的； 冒险的
locality|地区， 地点
proceeding|诉讼
artery|动脉； 干线， 要道
panic|恐慌， 惊慌失措 n. 恐慌，惊慌，慌乱
underestimate|对…估计不足，低估 n. 估计不足， 低估
fold|折叠，合拢 n. 褶， 折叠的部分
transient|短暂的， 转瞬即逝的； 临时的， 暂住的
hurl|猛投， 狠掷； 大声叫骂
competitive|竞争的， 比赛的； 好竞争的， 求胜心切的； 有竞争力的
dean|教长， 主任牧师； 学院院长， 系主任， 训导主任
sponge|用湿海绵擦， 揩； 过寄生生活 n. 海绵
abuse|滥用； 虐待； 辱骂， 毁谤 n. 滥用； 虐待； 辱骂
scheme|密谋， 策划 n. 计划，方案；阴谋
insulate|使绝缘， 使隔热， 使隔音； 隔离， 使隔绝
consequently|因此， 因而， 所以
drain|慢慢减少 vt. 排去，放水；渐渐耗尽 n. 耗竭； 排水沟， 排水管
reluctance|不愿， 勉强
rape|n&vt. 强奸
isolate|使隔离， 使孤立
popularity|普及， 流行； 声望
nickname|绰号，诨名 vt. 给…起绰号
subsequent|随后的， 后来的
metabolic|代谢作用的， 新陈代谢的
humanity|人类， 人； 人性； 人道， 博爱； 人文学科
innovation|新方法， 新事物； 革新， 创新
litter|乱扔废弃物 vt. 乱扔东西 n. 废弃物， 被胡乱扔掉的东西； 一窝； 杂乱的东西
charge|索价；控告；使充电，使充满；向前冲 n. 费用； 管理； 控告， 指责； 电荷， 充电
shutter|百叶窗； 快门
alternate|交替的， 轮流的； 间隔的 v. 轮流， 交替
biography|传记
procedure|程序； 手续； 步骤
sample|样品，试样，样本 vt. 从…抽样； 品尝， 体验
plunge|n&v. 纵身投入， 猛冲， 猛跌
skeptical|表示怀疑的
ultraviolet|紫外的
planetary|行星的
visa|签证
diagnose|诊断； 判断
petition|请愿， 正式请求 n. 请愿书，申请书；诉状
vicinity|周围地区， 邻近地区
naive|幼稚的； 天真的； 轻信的
essential|必要的，本质的 n. 要素； 必需品
expenditure|经费， 支出额； 花费， 支出， 消耗
vent|通风口，排放口；开衩 vt. 表达， 发泄
haunt|常出没于；使苦恼，使担忧；萦绕在心头，缠绕 n. 常去的地方
precede|在…之前， 先于
gasp|喘气，倒抽气 vt. 喘着气说出 n. 喘气， 倒抽气
stroll|n&vi. 散步， 闲逛
furnish|供应， 提供； 装备
differentiate|区分，区别 vt. 区分， 区别； 使不同， 使有差异
contact|接触，联系，交往 vt. 与…接触， 与…取得联系
garment|衣服
discharge|释放，排出；卸货 n. 释放， 放电
exclude|把…排除在外
scary|可怕的， 骇人的； 惊慌的， 害怕的； 胆小的， 易受惊的
criticism|批评， 批判； 评论， 评论文章
enlighten|启发， 开导
utmost|最远的 n. 极限
prospective|预期的； 未来的； 可能的
deduct|减去， 扣除
plaster|灰浆，灰泥；石膏；橡皮膏，膏药 vt. 在…上抹灰泥， 厚厚地涂抹
consultancy|顾问； 顾问服务公司
metropolitan|大都市的， 大都会的； 首都的
portray|描写， 描绘； 扮演， 饰演
garbage|垃圾， 废物； 废话； 无用的资料
suspicious|猜疑的， 疑心的； 可疑的； 表示怀疑的
scrub|用力擦洗，把…擦净；取消 n. 矮树丛， 灌木丛
complain|抱怨， 诉苦； 控告， 投诉
homogeneous|同种类的， 同性质的， 有相同特征的
affirm|断言， 坚持声称； 证实， 确认
profound|深度的， 深切的， 深远的； 知识渊博的， 见解深刻的； 深奥的
marble|大理石； 弹子； 弹子游戏
anxiety|焦虑， 忧虑； 渴望， 热望
adjust|适应 vt. 调整，调节；校正
aspiration|强烈的愿望； 志向， 抱负
vigorous|朝气蓬勃的； 有力的， 用力的
vocal|喜欢畅所欲言的，直言不讳的；嗓音的，发声的 n. 声乐节目
deem|认为， 视为
origin|起源， 起因； 出身， 血统
clash|发生冲突；不协调；砰地相撞，发出刺耳的撞击声 n. 冲突； 不协调； 刺耳的撞击声
overturn|倾覆， 翻转， 翻倒 vt. 使翻转，使倾覆，使倒下；颠覆，推翻
compel|强迫， 迫使屈服
depress|使沮丧， 使不景气； 按下
capable|有能力的， 有才能的
burden|重担，精神负担 vt. 加重压于， 烦扰； 负担， 装载
salute|敬礼，致意 vt. 向…敬礼，向…致意；赞扬，颂扬 n. 敬礼， 致意
clasp|扣子，钩子；紧抱，紧握 vt. 抱紧， 握紧； 扣住， 扣紧
symposium|讨论会， 专题报告会； 专题论文集
hover|翱翔； 逗留在近旁， 徘徊； 彷徨， 犹豫
random|任意的， 随机的
dine|进餐 vt. 宴请
personality|人格， 个性； 人物
sanction|批准，认可 n. 批准， 认可； 约束因素， 约束力； 国际制裁
alert|警觉的，留神的，注意的 vt. 使认识到，使意识到 n. 警戒， 戒备； 警报
deduce|推论， 推断， 演绎
oak|栎树， 橡树； 栎木， 橡木
client|委托人， 当事人； 顾客
sip|小口地喝，抿，呷 n. 小口喝， 一小口的量
dutiful|恭敬顺从的； 尽职的
contend|争夺，竞争；搏斗，争斗 vt. 声称， 主张
conversion|转变， 变换； 改变信仰， 皈依
brilliant|光辉的； 卓越的
gamble|赌博，打赌；投机，冒险 vt. 赌，以…为赌注 n. 赌博； 投机， 冒险
bound|一定的；有义务的 v. 跳跃；弹回，反跃；成为…的界限，给…划界 n. 跳跃； 界限， 限制
specification|规格， 规范； 明确说明； 说明书
deport|把…驱逐出境
counter|柜台； 计数器； 筹码
rhythm|韵律， 节奏
layman|门外汉， 外行
conserve|保护， 保藏， 保存
stroke|中风；一举，一次努力；划桨，划水；击，敲；报时的钟声；笔画，一笔；抚摸 vt. 抚摸
breed|繁殖； 养育， 培育； 酿成， 产生 n. 品种
tease|戏弄， 取笑； 挑逗， 撩拨
rash|轻率的，鲁莽的 n. 疹， 皮疹； 爆发的一连串
fragrance|芳香， 香味； 香水
management|管理； 处理； 管理部门， 管理人员
cylinder|圆柱体， 圆筒； 气缸， 泵体
fort|堡垒， 城堡
avoid|避免， 躲开； 撤销
comprehensive|广泛的； 综合的； 理解的
tunnel|挖， 开 n. 隧道，坑道，地道
assign|指派， 分配； 布置； 指定
withdraw|收回， 撤回； 撤退
straightforward|正直的， 坦率的； 易懂的， 简单的
elaborate|复杂的； 精心制作的 v. 详述， 详细制定
expert|熟练的 n. 专家
decade|十年， 十年期
fulfill|履行， 实现， 完成； 满足， 使满意
crowd|聚集， 挤， 涌 n. 群，一批 vt. 挤；挤满
congress|代表大会； 国会， 议会
mechanical|机械的， 机械制造的， 机械学的， 力学的； 呆板的
divine|神的， 神授的， 天赐的； 极好的， 极美的
slaughter|n&vt. 屠杀， 杀戮； 屠宰
foul|难闻的，发臭的；令人不愉快的，糟透了的；污浊的，肮脏的；下流的，辱骂性的；恶劣的，有暴风雨的；邪恶的，罪恶的 vt. 对…犯规；弄脏，弄污 n. 犯规
output|产量；输出，输出功率 vt. 输出
intricate|错综复杂的， 复杂精细的
fatigue|疲劳 n. 疲劳，劳累
agony|痛苦， 苦恼
contemplate|盘算， 计议； 思量， 对…周密考虑； 注视， 凝视
majority|多数， 大多数
drag|拖，拉；迫使，硬拉；拖着脚步走 n. 累赘； 一吸， 一抽
zinc|锌
costume|服装， 服饰； 戏装， 成套服装
clamp|夹紧，夹住，固定 n. 夹头， 夹具， 夹钳
issue|发行； 分发， 发出 n. 问题；发行；分发
maturity|成熟
vain|徒劳的； 自负的
decree|法令，政令；判决，裁决 vt. 判决， 命令
conservation|保存， 保护， 避免浪费； 守恒
supplement|增补， 补充； 增刊， 副刊 vt. 增补， 补充
contrast|形成对比， 对比之下显出区别 n. 对比，对照；反差[kən'trɑːst] vt. 对比，对照
verdict|裁定； 定论， 判断性意见
stereo|立体的；立体声的 n. 立体声
defy|违抗， 蔑视； 使成为不可能； 惹， 激
doctrine|教义， 教条； 主义
paragraph|段， 节
mediate|调解，斡旋 vt. 经调解解决； 经斡旋促成
pursuit|追求， 寻求； 追赶， 追逐； 事， 嗜好， 消遣
prophet|先知； 预言者
cycle|n&v. 自行车、 摩托车； 循环
amplify|放大， 增强； 扩大； 详述， 进一步阐述
lure|吸引，引诱，诱惑 n. 吸引力， 诱惑物； 诱饵， 鱼饵
disposal|丢掉， 销毁； 处理； 排列， 布置
settlement|解决； 协议； 居留地， 小社区
whirl|旋转，急转；发晕，变混乱 n. 旋转， 回旋； 混乱； 一连串的事
recede|退， 退去， 渐渐远去； 向后倾斜， 缩进
literature|文学， 文学作品； 文献， 图书资料
digest|消化， 领会 n. 文摘
slump|大幅度下降，暴跌；突然倒下 n. 萧条期， 低潮
prejudice|偏见，成见 vt. 使有偏见； 对…不利， 损害
clearance|净空， 余隙； 许可， 批准； 票据交换， 清算； 清除， 清理， 出空
customary|习惯上的， 惯常的， 合乎习俗的
immigrant|移民， 侨民
guardian|监护人； 守卫者， 保护者
veto|n&vt. 否决
thorn|刺， 荆棘； 带刺小灌木
disposition|性情， 性格； 意向， 倾向； 排列， 部署
corporate|法人团体的， 公司的； 全体的， 共同的
stabilize|稳定， 稳固
compensate|补偿， 弥补； 抵消
conscious|意识到的， 自觉的； 神志清醒的； 有意的， 存心的
transaction|交易， 业务
constant|经常的，不断的，连续发生的；永恒的；忠实的，忠诚的 n. 常数， 恒量
bribe|向…贿赂，买通 n. 贿赂， 行贿物
certify|证明， 证实； 发证书给
intermittent|间歇的， 断断续续的
outrage|义愤，愤慨；暴行，骇人听闻的事件 vt. 激起…的义愤， 激怒
solitary|单独的， 独自的； 单个的， 唯一的； 孤独的， 隐居的
diffuse|扩散， 弥漫； 传播， 散布 adj. 冗长的， 漫无边际的； 四散的， 弥漫的
scramble|攀登，爬；争夺，抢夺 vt. 扰乱，搞乱 n. 攀登， 爬行； 争夺， 抢夺
orchestra|管弦乐队
immerse|使浸没； 使沉浸在， 使专心于
sufficient|足够的， 充分的
marshal|元帅，最高指挥官；总指挥，司仪；执法官，警察局长，消防队长 vt. 整理， 排列， 集结
champagne|香槟酒
claim|声称，主张；对…提出要求，索取；使失踪或死亡；需要，值得 n. 要求； 认领； 索赔； 声称， 断言
widespread|分布广泛的， 普遍的
antique|古时的，古老的 n. 古物， 古玩， 古董
communication|通讯， 交流， 交际； 通信工具， 交通联系
chronic|慢性的， 久病的； 长久的， 不断的； 积习难改的
toxic|有毒的， 因中毒引起的
contest|竞赛， 争夺 vt. 争夺， 与…竞争； 对…提出质疑， 辩驳
author|著作家， 作者
lever|杠，杠杆；途径，手段，工具 vt. 撬动， 撬起
preserve|保护， 维持； 保存， 保藏； 腌制
establish|建立， 设立； 确立； 证实
expansion|扩大； 扩充； 扩张； 膨胀
wrench|猛拧，猛扭；挣脱；使扭伤 n. 痛苦， 难受； 猛扭， 猛拉； 扳手
relevant|有关的， 切题的
expand|扩大， 膨胀
gaze|n&vi. 凝视， 盯， 注视
proclaim|宣告， 宣布， 声明； 显示
magistrate|地方行政官， 地方法官； 治安官
retrieve|重新得到， 取回， 收回； 挽回， 补救； 检索
survey|俯瞰， 眺望； 全面审视， 调查； 测量， 勘定 n. [sə'veɪ]
jeopardize|危及， 危害
spy|当间谍；暗中监视 n. 间谍 vt. 看见， 发现
displace|取代， 替代； 迫使…离开家园， 使离开原位
predominant|占主导地位的， 显著的
recipe|烹饪法， 食谱； 方法， 秘诀， 诀窍
ideology|思想， 思想意识
mental|心理的， 精神的， 思想上的； 精神病的； 智力的
decent|像样的， 过得去的， 体面的； 宽厚的， 大方的； 正派的； 合乎礼仪的， 得体的
seam|缝， 接缝； 煤层
investigate|调查， 研究
racial|种族的， 人种的
illusion|幻想， 错误的观念； 错觉， 幻觉， 假象
considerable|相当大的； 重要的
productivity|生产力； 生产率
proposition|论点， 主张； 建议， 提案； 命题
reserve|保留，留存；预订 n. 储备； 保留； 拘谨， 矜持； 替补队员； 后备部队； 自然保护区
savage|残暴的，凶猛的，粗鲁的；未开化的，野蛮的 n. 野蛮人，粗鲁的人 vt. 乱咬； 激烈抨击
heap|堆， 大量
sympathy|同情； 一致； 支持， 赞同
consumer|消费者， 用户， 消耗者
cripple|跛子，伤残人 vt. 使跛， 使受伤致残； 严重削弱， 使陷入瘫痪
brief|简短的，短暂的 vt. 向…介绍基本情况，做…的提要 n. 概要， 摘要
console|安慰，慰问 n. 控制台， 操纵台
initiative|主动性， 首创精神； 主动的行动， 倡议； 主动权
recover|重新获得， 挽回； 恢复
clockwise|顺时针方向地
embark|上船； 着手， 开始工作
medication|药物治疗； 药物
drill|钻， 打； 训练 n. 钻头；操练，训练
friction|不和， 抵触； 摩擦
confer|商谈，商议 vt. 授予， 赋予
intelligent|聪明的； 理智的
clerk|店员； 办事员， 职员
acknowledge|承认， 承认…的权威； 告知收到， 确认； 对…表示谢意， 报偿
equip|装备， 配备； 使有准备
deferential|恭敬的， 恭顺的
manuscript|手稿， 原稿， 底稿； 手写本
luxury|奢侈； 奢侈品
overthrow|推翻，打倒；使终止，摒弃 n. 推翻， 终止， 结束
knit|编结， 编织； 愈合 vt. 编结，编织；使紧密地结合，使紧凑；皱紧，皱
inflict|把…强加给； 使…遭受， 使…承担
worthwhile|值得花时间做的
inland|在内地， 向内地 adj. 内陆的， 内地的
stumble|绊脚， 绊倒； 跌跌撞撞地走； 结结巴巴
specialty|特产， 名产， 特色菜； 专业， 专长
vary|变化， 有差异 vt. 改变，使多样化
readily|乐意地， 欣然地； 容易地； 很快地， 立即
coherent|条理清楚的， 连贯的； 一致的， 协调的
intercourse|性交； 交流， 交往， 交际
convenience|方便； 便利设施
decency|得体；宽容，大方；正派，合乎礼仪，体面；
falsehood|谬误， 虚假； 谎言， 说谎
discipline|纪律，训练；惩罚；学科 vt. 训练； 惩罚， 处罚
ponder|思索， 考虑， 沉思
objective|客观的， 无偏见的 n. 目标，目的
exert|用， 尽； 运用， 行使
scandal|丑事， 丑闻； 流言蜚语； 反感， 愤慨
composite|混合成的，综合成的 n. 合成物； 复合材料
hinder|阻碍， 妨碍
scent|香味，气味；臭迹；踪迹，线索；香水 vt. 嗅到， 察觉
estimate|估计； 评价 n. 估计； 评价； 看法
diploma|毕业文凭， 毕业证书， 资格证书
exhibit|显示；陈列，展览 n. 展览品
brand|商标，牌子 vt. 铭刻， 打烙印于； 加污名于， 谴责
suspension|暂停， 中止； 暂令停止参加， 暂时剥夺； 悬架， 悬置机构； 悬浮液； 悬， 挂， 吊
alcohol|酒精， 乙醇
inevitable|不可避免的， 必然的
deny|否定， 拒绝相信
trench|沟， 沟渠
subtract|减， 减去； 去掉
recreation|娱乐活动， 消遣
frustration|挫败， 挫折， 受挫
allowance|津贴， 补贴； 零用钱
hurricane|飓风
hike|徒步旅行 n. 徒步旅行；增加，上升 vt. 提高
ancient|古代的， 古老的； 年老的， 看上去很老的
mission|使命， 任务； 使团
cognitive|认知的， 认识能力的
adopt|收养； 采用， 采取； 正式通过， 批准
expire|期满， 终止； 断气， 死亡
smuggle|走私， 非法私运； 偷运， 偷带
hustle|催促，赶紧做；猛推，挤，强迫 n. 忙碌， 奔忙； 挤
oppose|反对， 反抗
device|器械， 装置； 设计； 手段， 策略
commentary|实况报道， 解说词； 评论， 评论文章
sue|控告， 起诉； 要求， 请求
conservative|保守的，守旧的；不时兴的，传统的 n. 保守的人
belly|肚子， 腹部
access|接近；通道，入口；接近的机会 vt. 存取
conference|会议， 讨论会； 讨论， 商谈
primitive|原始的，早期的；简单的；粗糙的 n. 原人； 原始事物
knob|球形把手， 球形柄； 旋钮； 小块
advisable|可取的； 适当的
overcome|战胜， 克服； 压倒， 使受不了
cabin|小屋； 船舱， 机舱
recite|背诵， 朗诵； 列举， 一一说出
oppress|压迫， 压制； 使沉重， 使烦恼
current|当前的，通用的；流行的，流传的 n. 潮流； 电流； 趋势， 倾向
heel|脚后跟， 踵； 后跟
gloom|昏暗， 阴暗； 忧郁， 沮丧
adore|崇拜， 敬慕； 爱慕， 热爱； 非常喜欢
persist|坚持， 持续
caution|小心，谨慎；注意，警告 vt. 警告， 劝…小心
offensive|冒犯的，无礼的，使人不快的；进攻的，攻击性的 n. 进攻， 攻势
texture|质地； 结构
closet|私下的；隐蔽的 n. 橱，壁橱 vt. 把…引进密室会谈
speculate|推测， 推断； 投机， 做投机买卖
dismantle|拆开， 拆卸
monster|大的， 庞大的 n. 怪物；极其残酷的人；巨人，巨兽，巨大的东西
bud|发芽， 萌芽 n. 花蕾，叶芽
confirm|证实， 肯定； 确认； 批准
bug|虫子；小病；故障，缺陷；窃听器 vt. 烦扰， 纠缠； 在…装窃听器
prescient|预知的， 预见的
acquaint|使认识， 使了解； 使熟悉
elastic|有弹性的； 灵活的 n. 松紧带
consequent|作为结果的， 随之发生的
vast|巨大的， 大量的； 浩瀚的
intervene|干涉， 干预； 干扰， 阻挠
symbol|象征； 符号， 标志
ignite|着火 vt. 点燃，引发
commercial|商业的， 商务的； 商品化的， 商业性的
revelation|被提示的真相， 新发现； 揭示， 透露， 显示
available|现成可使用的， 通用的； 可取的； 联系的； 可得到的
innumerable|无数的， 数不清的
advocate|拥护， 提倡， 主张 n. 拥护者， 提倡者； 辩护者， 律师
confine|限制，使局限；使不外出，禁闭
quest|寻找， 搜索； 追求
frequency|屡次， 次数， 频率； 经常发生
elicit|诱出， 探出
relegate|使降位， 使降级； 把…委托给
trivial|琐碎的， 不重要的
burial|葬， 掩埋； 葬礼
luggage|行李
drawback|缺点， 欠缺； 不利条件
longevity|长寿， 寿命
military|军事的；军用的 n. 军队， 武装力量
dynamic|动力的， 动力学的； 动态的； 有活力的， 有生气的
wardrobe|衣柜； 全部衣物
reluctant|不情愿的， 勉强的
conscientious|认真的， 勤勤恳恳的
passion|激情， 热情； 酷爱
generate|发生， 引起； 生殖
extreme|极度的；最后的 n. 极端， 过分
tuck|把边塞到下面；把…夹入，把…藏入 n. 褶， 裥
authoritative|有权威性的， 可信的； 专断的， 命令式的
athlete|运动员， 体育家
upright|挺直着， 竖立着 adj. 垂直的；正直的，诚实的
extract|取出，抽出；采掘，提炼，榨取；获得，索取；摘录['3kstrækt] n. 摘录， 选段； 提出物， 精， 汁
obscure|不著名的，不重要的；费解的，模糊不清的 vt. 使变糊， 掩盖
dismay|失望，气馁；惊恐 vt. 使失望， 使气馁； 使惊恐
expend|花费， 消费； 消耗
forge|打制， 锻造； 伪造
demonstrate|说明， 论证； 表露
region|地区， 地带， 区域； 范围， 幅度
deceive|行骗 vt. 欺骗，蒙蔽
preview|预映， 预演； 预告
ingenious|设计独特的， 别致的， 巧妙的； 灵巧的， 善于创造发明的
questionnaire|问卷， 征求意见表
breakthrough|突破， 突破性进展， 重要的新发现
snack|快餐， 小吃， 点心
yoke|牛轭；束缚，枷锁 vt. 结合， 联结
destination|目的地， 终点； 目标
throne|御座， 宝座； 王位， 王权
privacy|个人自由； 隐私， 私生活， 私事
reciprocal|相互的； 互惠的
vertical|垂直的， 竖式的
inventory|详细目录， 存货清单
vivid|鲜艳的； 生动的， 栩栩如生的
flush|发红 adj. 齐平的， 同高的
heir|继承人
screw|螺丝 vt. 用螺钉固定， 拧， 拧紧
kit|成套工具，成套用品；配套元件 vt. 装备
virtue|善， 美德； 优点， 长处
emphasize|强调， 着重
turnover|营业额， 成交量； 人员调整， 人员更替率
mortal|终有一死的；致命的；你死我活的，不共戴天的 n. 凡人， 人类
coverage|新闻报道； 覆盖范围
figure|出现；合乎情理 n. 数字；人物；算术；体型，风姿；轮廓；画像，塑像；图，图形 vt. 计算； 认为， 猜想
brutal|野兽般的， 残忍的； 无情的， 冷酷的， 难以忍受的
slight|轻微的，微小的 v. 侮慢；轻视，冷落
ore|矿， 矿石
corrupt|堕落的，腐败的，贪赃舞弊的 vt. 腐蚀， 使堕落
preclude|排除； 阻止， 妨碍
previous|先的， 前的， 以前的
regime|政治制度， 政权
transmit|传送， 传递； 传染； 播送， 发射
commemorate|纪念， 庆祝
argue|争论，争辩，辩论 vt. 主张； 说服
consumption|消耗， 消费； 肺病
premature|比预期时间早的； 不成熟的， 仓促的
superior|上级的，较高的；优越的；有优越感的，高傲的 n. 上级， 长官
drought|干旱， 旱灾
periodical|周期的； 定期的； 时而发生的 n. 期刊
leaflet|散发传单 n. 传单，散页印刷品，小册子
accessory|附件， 零件， 配件； 装饰品； 同谋， 帮凶， 包庇犯
compromise|妥协； 危及； 放弃 n. 妥协，和解；折中办法
retort|n&v. 反驳， 回嘴
electrify|使充电， 使电气化； 使激动， 使兴奋
seminar|研究班， 研讨会
fringe|附加的 n. 刘海；饰以流苏的边；边缘，外围 vt. 成为…的边缘
competition|比赛； 竞争
beyond|在更远处， 再往后 prep. 在…的那边，远于；迟于；越出
hazard|危险，公害 vt. 尝试着做， 冒…风险
justify|证明…是正当的
dreadful|糟透了的， 极不合意的； 极端的， 极其大的； 可怕的
voluntary|自愿的， 志愿的
connection|连接； 联系； 连接物， 连接点； 亲戚
proof|耐…的， 能防…的 n. 证据，证明；校样，样张
militant|激进的；好斗的 n. 激进分子， 斗士
simulate|模仿， 模拟； 假装， 冒充
intricacy|错综复杂；
phase|阶段； 方面； 相， 相位
dilute|稀释的， 冲淡的 vt. 稀释，冲淡
inclusive|包括一切的， 包括一切费用在内的； 所有数目包括在内的
efficiency|效率； 功效， 效能
ethnic|种族的
spectacle|演出， 场面； 景象， 壮观； 眼镜
overhead|在头顶上 adj. 在头顶上的；架空的 n. 经常费用， 管理费用
contract|缩小； 订合同； 感染， 染上 n. 契约， 合同
conclude|结束， 终了 vt. 推断出，推论出；缔结，议定
profitable|有利可图的， 有益的
misfortune|不幸， 厄运， 逆境； 不幸事故， 灾难， 灾祸
comprehension|理解， 理解力， 领悟； 理解力测验
susceptible|易受影响的； 过敏的； 能经受的， 容许的
leather|皮革； 皮革制品
insight|洞察力； 洞悉， 深刻的见解
intact|完整无缺的； 未经触动的； 未受损伤的
instrumental|起作用的， 有帮助的； 用乐器演奏的
fabric|织物， 纺织品； 结构
revolutionary|革命的；革新的 n. 革命者
unemployment|失业， 失业人数
juvenile|少年的，少年特有的；幼稚的，不成熟的 n. 未成年人， 少年
force|强迫；用力推动，用力打开 n. 军队， 兵力； 暴力， 武力； 力， 力气； 影响力， 效力
sympathetic|同情的； 和谐的； 赞同的， 支持的； 合意的
periodic|周期的， 定期的， 时而发生的
distribution|分发， 分配， 分布
derive|起源， 衍生 vt. 取得，得到；追溯…的起源或来由
capacity|容量； 能力； 能量； 才能； 身份， 地位
cope|应付， 处理
overhear|无意中听到， 偷听到
dart|猛冲，飞奔 vt. 投射 n. 飞镖， 飞镖游戏； 急驰， 飞奔
flaw|缺点， 瑕疵， 缺陷
saturate|使湿透， 浸透； 使充满， 使饱和
feature|特征，特色；面貌；特写，专题节目；故事片 vt. 突出； 由…主演
flat|平直地； 直截了当地 adj. 平的；固定的；漏气的；单调的，沉闷的；浅的 n. 一套房间，单元住宅
assert|肯定地说， 断言； 维护， 坚持； 坚持己见
climax|高潮， 最令人兴奋的部分
recall|回忆； 召回， 叫回； 收回， 撤销
rectangular|长方形的， 矩形的
flap|飘动， 拍动； 振翅 n. 片状垂悬物；飘动，摆动，振动；激动，慌忙状态 vt. 使拍动，使飘动
precise|精确的， 准确的； 严谨的
sensible|明智的， 合情理的
objection|反对， 异议； 反对的理由
precious|珍贵的， 宝贵的
contrive|谋划， 策划； 设法做到； 设计， 想出
inhabitant|居民， 住户
fraction|小部分， 片断； 【数】 分数
token|象征性的， 装样子的 n. 筹码；信物，标志，纪念品；代金券，礼券
emotion|情感， 感情； 激动
massive|大的， 大而重的； 大块的； 大量的， 大规模的
assess|对估价； 评价， 评论
mingle|混合起来， 相混合； 相交往， 相往来 vt. 使混合，使相混
prescription|处方， 药方， 药； 开处方， 开药方
spectator|观众， 旁观者
edible|可以吃的， 可食用的
prone|易于…的， 很有可能…的； 俯卧的
chorus|合唱队；合唱，合唱曲；副歌，叠句；齐声，齐声说的话 vt. 齐声说， 随声附和
owe|欠； 应把…归功于； 感激， 感恩
asset|资产， 财产； 有价值的特性或技能， 优点
exposition|阐述， 讲解； 展览会， 博览会
minimum|最低的， 最小的 n. 最低限度，最小量
apology|道歉， 认错， 谢罪
reveal|揭露， 泄露； 展现， 显示
adequate|足够的； 可以胜任的
owl|猫头鹰
cork|软木，软木塞 vt. 用瓶塞塞住
tremendous|极大的， 非常的； 精彩的， 了不起的
norm|标准， 规范； 准则
condense|使冷凝， 使凝结； 浓缩， 压缩， 简缩
impetus|推动， 促进， 刺激； 推动力
indignation|愤怒， 愤慨， 义愤
barrier|栅栏； 检票口； 屏障； 障碍， 隔阂
realistic|现实的； 实际可行的； 现实主义的， 逼真的
divert|使转向， 使改道； 转移， 转移…的注意力； 使娱乐， 使消遣
conspicuous|显眼的， 明显的
verse|诗， 诗句
criminal|犯罪的， 刑事的 n. 犯人，罪犯，刑事犯
furious|狂怒的， 暴怒的； 强烈的， 激烈的
obesity|过度肥胖
tan|晒成棕褐色 vt. 使晒成棕褐色；硝制 n. 棕褐色， 棕黄色； 晒成棕褐色， 晒黑
individual|个别的；独特的 n. 个人， 个体
briefcase|公文包， 公事包
nuisance|讨厌的人； 麻烦事
brace|做好准备；振作精神 vt. 使防备，使受锻炼；支住，撑牢，使绷紧 n. 支架， 托架
constrain|限制， 约束； 克制， 抑制
brisk|轻快的， 生气勃勃的； 兴隆的， 繁忙活跃的； 寒冷而清新的
prestige|威信， 威望
insulation|绝缘
cord|细绳， 粗线， 索； 灯芯绒裤
startle|使惊吓， 使吃惊
interim|暂时的，临时的 n. 间歇， 过渡期间
fraud|欺诈， 诈骗； 骗子
testimony|证词； 见证， 证明
council|理事会， 委员会
reaffirm|重申； 再确认
enforce|实施， 执行； 强制， 强迫， 迫使
glitter|闪闪发光，闪耀 n. 闪光， 灿烂的光辉； 耀眼， 辉煌
destined|命中注定的， 预定的； 以…为目的地的
repression|压抑， 压制， 镇压
fragile|易碎的， 脆的， 易损坏的； 虚弱的， 脆弱的
penalty|处罚， 惩罚； 罚金
sociology|社会学
exile|流放，流亡；被流放者，流亡国外者 vt. 流放， 放逐， 使流亡
scale|大小，规模；等级，级别；天平，磅秤；比例；刻度，标度；鳞 vt. 攀登， 爬越
gigantic|巨大的， 庞大的
distinct|与其他不同的； 清楚的， 明确的
vegetation|植物， 草木
recovery|恢复， 痊愈； 追回， 寻回， 收复
geology|地质学； 地质情况
hoist|举起，升起，吊起 n. 起重器械； 举起， 升起， 吊起
aware|知道的， 意识到的
quart|夸脱
numerical|数字的； 用数字表示的； 数值的
limp|一瘸一拐地走，蹒跚 adj. 软弱的，无生气的，无精神的；软的，松沓的 n. 跛行
security|安全， 保障； 抵押品； 证券
award|奖，奖品；判定 vt. 授予， 给予； 判给， 裁定
buck|猛然弓背跃起 n. 美元，澳元；雄鹿，雄兔
eligible|有条件被选中的； 合适的， 合意的
alarm|惊恐，忧虑，警报 vt. 使惊恐， 使担心
feeble|虚弱的， 衰弱的， 无力的； 无效的， 无益的
appraisal|估计， 估量； 评价
continual|连续的； 频频的
herb|药草， 香草； 草本植物
prose|散文
limb|肢， 臂， 腿； 树枝
orientation|方向， 目标， 方位； 熟悉情况， 适应， 情况介绍
refreshment|茶点， 点心； 恢复， 精神爽快
confidence|信任， 信赖； 信心， 自信
arbitrary|随心所欲的； 专断的
intent|专心的， 专注的； 急切的 n. 意图，意向，目的
passive|被动的， 消极的
fertilizer|肥料
corresponding|相应的， 符合的
oath|誓言， 誓约； 咒骂， 诅咒语
response|回答， 答复； 反应， 响应
treaty|条约， 协议， 协定
dignity|庄严， 端庄； 尊严， 高贵
challenge|挑战，邀请比赛；艰巨的任务；怀疑，质问 vt. 反对， 公然反抗； 向…挑战； 对…质疑
rival|竞争的，对抗的 n. 竞争对手，敌手；可与匹敌的人 vt. 与…竞争； 与…匹敌， 比得上
