beddings|寝具；（建筑）[建] 基床；（家畜）草垫 adj. 适于花坛种植的 vt. 把…栽入苗床（bed的ing形式） vi. 睡（bed的ing形式）
although|尽管；虽然；但是；然而
effort|努力；成就
preference|偏爱，倾向；优先权
beneath|在…之下 adv. 在下方
currency|货币；通货
warmth|温暖；热情；激动
adapt|使适应；改编
rewrite|改写；重写 n. 重写或改写的文稿；改写的作品
fourteen|十四；十四个；第十四 n. 十四的记号；十四岁；十四点钟；十五世纪
steam|蒸，散发；用蒸汽处理 n. 蒸汽；精力 adj. 蒸汽的
piano|钢琴
firm|坚定的；牢固的；严格的；结实的 v. 使坚定；使牢固 adv. 稳固地 n. 公司；商号
bake|烤，烘焙 n. 烤；烘烤食品
suggest|提议，建议；启发；使人想起；显示；暗示
happily|快乐地；幸福地；幸运地；恰当地
changeable|无常的；可改变的；易变的；不定的
happen|发生；碰巧；偶然遇到
stream|溪流；流动；潮流；光线 v. 流；涌进；飘扬
late|晚的；迟的；已故的；最近的 adv. 晚；迟；最近；在晚期
hey|喂！（引起注意等）；你好！（表示问候） n. 干草（等于hay）
charge|费用；电荷；掌管；控告；命令；负载 v. 使充电；使承担；指责；装载；对…索费；向…冲去
treat|治疗；对待；探讨；视为 n. 请客；款待
simplify|简化；使单纯；使简易
statesman|政治家；国务活动家
reservation|预约，预订；保留
framework|框架，骨架；结构，构架
consider|考虑；认为；考虑到；细想
gram|克；鹰嘴豆（用作饲料）
dvd|数字化视频光盘（Digital Video Disk）
superior|上级的；优秀的，出众的；高傲的 n. 上级，长官；优胜者，高手；长者
achievement|成就；完成；达到；成绩
urgent|紧急的；急迫的
sense|感觉，功能；观念；道理；理智 v. 感觉到；检测
foresee|预见；预知
try|试图，努力；试验；审判；考验 n. 尝试；努力；试验
compass|指南针，罗盘；圆规 v. 包围
headteacher|中小学的校长
earn|赚，赚得；获得，挣得；使得到；博得 n. (Earn)人名；(泰)炎
collect|收集；募捐 adv. 由收件人付款地 adj. 由收件人付款的 n. (Collect)人名；(英)科莱克特
mask|面具；口罩；掩饰 v. 掩饰；戴面具；化装
assume|假定；设想；承担；采取
player|运动员，比赛者；游戏者，做游戏的人；演奏者，表演者；演员；播放器
revision|[印刷] 修正；复习；修订本
farm|种田，务农；经营农场 n. 农场；农家；畜牧场
hive|群居；入蜂房；生活在蜂房中 n. 蜂房，蜂巢；热闹的场所；熙攘喧闹的人群
year|年；年度；历年；年纪；一年的期间；某年级的学生
continue|继续，延续；仍旧，连续
contradict|反驳；否定；与…矛盾；与…抵触
usually|通常，经常
persuade|说服，劝说；使某人相信；劝某人做（不做）某事 adj. 空闲的，有闲的
mental|精神的；脑力的；疯的 n. 精神病患者
hawk|兜售，沿街叫卖；捕捉；咳出 n. 鹰；鹰派成员；掠夺他人的人
clothes|衣服
plastic|塑料的；（外科）造型的；可塑的 n. 塑料制品；整形；可塑体
terrible|可怕的；很糟的；令人讨厌的 adv. 很，非常
bedclothes|床上用品；铺盖
award|授予；判定 n. 奖品；判决
surround|围绕；包围 n. 围绕物 adj. 环绕立体声的
humour|幽默（等于humor）；诙谐 v. 迁就；使满足
hostess|女主人，女老板；女服务员；舞女；女房东
speaker|演讲者；扬声器；说话者；说某种语言的人
successful|成功的；一帆风顺的
chance|机会，际遇；运气，侥幸；可能性 v. 偶然发生；冒……的险
lid|盖子；眼睑；限制 vt. 给…盖盖子
dollar|美元
man|人；男人；人类；丈夫；雇工 v. 操纵；给…配置人员；使增强勇气；在…就位
ten|十个，十 n. (Ten)人名；(英)坦恩；(意)泰恩；(柬)登
pay|支付，付；偿还，补偿；给予 n. 工资，薪水；付款；报答 adj. 收费的；需付费的
under|低于，少于；在之下 adv. 在下面；在下方 adj. 下面的；从属的
leading|领导的；主要的 n. 领导；铅板；行距 v. 领导（lead的ing形式）
asia|亚洲
typewriter|打字机
even|[数] 偶数的；平坦的；相等的 adv. 甚至；即使；还；实际上 v. 使平坦；使相等 n. (Even)人名；(法)埃旺；(德)埃文；(英)埃文
luggage|行李；皮箱
escape|逃避，避开，避免；被忘掉；被忽视 n. 逃跑；逃亡；逃走；逃跑工具或方法；野生种；泄漏
powder|粉；粉末；[化工][军] 火药；尘土 v. 使成粉末；撒粉；搽粉于
zebra|[脊椎] 斑马 adj. 有斑纹的
overcoat|大衣，外套
popcorn|爆米花，爆玉米花
affair|事情；事务；私事；（尤指关系不长久的）风流韵事
steward|管家；乘务员；膳务员；工会管事 vi. 当服务员；当管事 vt. 管理
available|可获得的；可购得的；可找到的；有空的
import|进口，进口货；输入；意思，含义；重要性 v. 输入，进口；含…的意思
cupboard|碗柜；食橱
date|日期；约会；年代；枣椰子 v. 过时；注明日期；始于（某一历史时期）
pollution|污染
jar|罐；广口瓶；震动；刺耳声 v. 冲突；不一致；震惊；发刺耳声
anything|任何事
suspension|悬浮；暂停；停职
italian|意大利的；意大利文化的；意大利语的 n. 意大利人；意大利语
essay|散文；试图；随笔 v. 尝试；对…做试验
honest|诚实的，实在的；可靠的；坦率的
new|新的，新鲜的；更新的；初见的 adv. 新近 n. (New)人名；(英)纽
pause|暂停；间歇 v. 暂停，停顿，中止；踌躇
sunlight|日光
disturb|打扰；妨碍；使不安；弄乱；使恼怒
distribute|分配；散布；分开；把…分类
stable|马厩；牛棚 adj. 稳定的；牢固的；坚定的 v. 被关在马厩
straw|稻草；吸管；一文不值的东西 adj. 稻草的；无价值的
therefore|因此；所以
ankle|踝关节，踝
bookstore|书店（等于bookshop）
hardship|困苦；苦难；艰难险阻
butter|涂黄油于；讨好 n. 黄油；奶油；奉承话
postpone|使…延期；把…放在次要地位；把…放在后面
physicist|物理学家；唯物论者
lantern|灯笼；提灯；灯笼式天窗
panic|恐慌，惊慌；大恐慌 adj. 恐慌的；没有理由的 v. 使恐慌
europe|欧洲
disappear|消失；失踪；不复存在
downtown|往闹市区；在市区 adj. 市中心的 n. 市中心区；三分线以外
ask|问，询问；要求；需要；邀请；讨价 n. (Ask)人名；(芬、瑞典)阿斯克
amuse|娱乐；消遣；使发笑；使愉快
criterion|（批评判断的）标准；准则；规范；准据
shuttle|航天飞机；穿梭；梭子；穿梭班机、公共汽车等 v. 使穿梭般来回移动；短程穿梭般运送
publish|出版；发表；公布
zoo|动物园
perhaps|或许；（表示不确定）也许；（用于粗略的估计）或许；（表示勉强同意或其实不赞成）也许；可能 n. 假定；猜想；未定之事
pressure|压力；压迫，[物] 压强 v. 迫使；密封；使……增压
viewer|观察者；观看者；观众；[仪] 指示器
being|存在；生命；本质；品格 adj. 存在的；现有的
anxiety|焦虑；渴望；挂念；令人焦虑的事
atom|原子
basis|基础；底部；主要成分；基本原则或原理
terrify|恐吓；使恐怖；使害怕
electric|电的；电动的；发电的；导电的；令人震惊的 n. 电；电气车辆；带电体
disappoint|使失望
toast|干杯；烤面包；接受敬酒的人；（在某领域）广受赞誉的人 v. 向…祝酒，为…干杯
explode|爆炸，爆发；激增
retell|复述；再讲；重述
salary|给加薪；给薪水 n. 薪水
cyclist|骑自行车的人
stomachache|腹痛，肚子痛；胃痛
agency|代理，中介；代理处，经销处
chalk|用粉笔写；用白垩粉擦；记录；规划 n. 粉笔；白垩；用粉笔划的记号 adj. 用粉笔写的
dignity|尊严；高贵
hard|努力的；硬的；困难的；辛苦的；确实的；严厉的；猛烈的；冷酷无情的 adv. 努力地；困难地；辛苦地；接近地；猛烈地；牢固地 n. (Hard)人名；(英、芬、瑞典)哈德
half|一半；半场；半学年 adv. 一半地；部分地 adj. 一半的；不完全的；半途的
fragile|脆的；易碎的
comrade|同志；伙伴
duty|责任；[税收] 关税；职务
pile|堆；大量；建筑群 v. 累积；打桩于
worn|疲倦的；用旧的 v. 穿；磨损（wear的过去分词）；佩戴 n. (Worn)人名；(柬)翁；(英、葡)沃恩
click|点击；使发咔哒声 n. 单击；滴答声
heaven|天堂；天空；极乐
attentively|注意地；聚精会神地；周到地
hamburger|汉堡包，火腿汉堡；牛肉饼，肉饼；碎牛肉
pleased|高兴的；喜欢的；乐意做某事 v. 满意；愿意（please的过去分词形式）
ouch|扣环 int. 哎哟（突然疼痛时发出的声音）
carpenter|木匠，木工 v. 当木匠，做木匠工作
giraffe|长颈鹿
cycle|循环；周期；自行车；整套；一段时间 v. 使循环；使轮转
caption|标题；字幕；说明；逮捕 v. 加上说明；加上标题
twist|捻；拧；扭伤；编织；使苦恼 n. 扭曲；拧；扭伤
prefer|更喜欢；宁愿；提出；提升
shelf|架子；搁板；搁板状物；暗礁
civilian|民用的；百姓的，平民的 n. 平民，百姓
pull|拉；拔；拖 n. 拉，拉绳；拉力，牵引力；拖
still|仍然；更；静止地 adj. 静止的，不动的；寂静的，平静的；不起泡的 n. 寂静；剧照；蒸馏室 conj. 仍然；但是；尽管如此 v. 蒸馏；使…静止；使…平静下来
wildlife|野生动植物 adj. 野生动植物的
training|训练；培养；瞄准；整枝 v. 训练；教养（train的ing形式）
harmless|无害的；无恶意的
lie|躺；说谎；位于；展现 n. 谎言；位置
spoken|口语的，口头的 v. 说（speak的过去分词）
native|本国的；土著的；天然的；与生俱来的；天赋的 n. 本地人；土产；当地居民
foggy|有雾的；模糊的，朦胧的
better|长辈；较好者；打赌的人（等于bettor） adv. 更好的；更多的；较大程度地 adj. 较好的 v. 改善；胜过
main|主要部分，要点；体力；总管道 adj. 主要的，最重要的；全力的
meeting|会议；会见；集会；汇合点 v. 会面；会合（meet的ing形式）
advertisement|广告，宣传
semicircle|半圆，半圆形
pioneer|先锋；拓荒者 v. 开辟；倡导；提倡
paper|纸；论文；文件；报纸 adj. 纸做的 v. 用纸糊；用纸包装
officer|军官，警官；公务员，政府官员；船长 v. 指挥
millionaire|百万富翁；大富豪 adj. 100万以上人口的
memorial|纪念碑，纪念馆；纪念仪式；纪念物 adj. 记忆的；纪念的，追悼的
envy|嫉妒，妒忌；羡慕 v. 嫉妒，妒忌；羡慕
woo|追求；招致；向…求爱；恳求
mountain|山；山脉
impress|盖印；强征；传送；给予某人深刻印象 n. 印象，印记；特征，痕迹
association|协会，联盟，社团；联合；联想
package|包，包裹；套装软件，[计] 程序包 adj. 一揽子的 v. 打包；将…包装
shark|鲨鱼；骗子 v. 诈骗
sort|种类；方式；品质 v. 分类；协调；交往
ox|牛；公牛
nurse|看护，护理；照顾；培养；给…喂奶 n. 护士；奶妈，保姆
enemy|敌人，仇敌；敌军 adj. 敌人的，敌方的
grasp|抓住；理解；控制 v. 抓住；领会
movie|电影；电影院；电影业 adj. 电影的
coincidence|巧合；一致；同时发生
appearance|外貌，外观；出现，露面
garment|衣服，服装；外表，外观 v. 给…穿衣服
agricultural|农业的；农艺的
become|成为；变得；变成
western|西方的，西部的；有西方特征的 n. 西方人；西部片，西部小说
want|需要；希望；应该；缺少 n. 需要；缺乏；贫困；必需品
worry|担心；烦恼；撕咬 v. 担心；发愁；折磨
law|法律；规律；法治；法学；诉讼；司法界 vi. 起诉；控告 vt. 控告；对…起诉
minus|减，减去 n. 负号，减号；不足；负数 adj. 减的；负的
thinking|思考的；思想的；有理性的；好思考的 n. 思考；思想；想法；意见；见解 v. 思考（think的现在分词）
administration|管理；行政；实施；行政机构
eye|眼睛；视力；眼光；见解，观点 v. 注视，看
marriage|结婚；婚姻生活；密切结合，合并
fifty|五十；五十个；编号为50的东西 adj. 五十的；五十个的；众多的
broom|扫帚；金雀花 v. 扫除
represent|代表；表现；描绘；回忆；再赠送
to|向前；（门等）关上 prep. 到；向；（表示时间、方向）朝…方向 n. (To)人名；(柬)多；(中)脱(普通话·威妥玛)
near|近的；亲近的；近似的 adv. 近；接近 prep. 靠近；近似于
shabby|破旧的；卑鄙的；吝啬的；低劣的
glory|光荣，荣誉；赞颂 v. 自豪，骄傲；狂喜
effect|影响；效果；作用 v. 产生；达到目的
liberation|释放，解放
fax|传真 n. 传真
state|国家；州；情形 v. 规定；声明；陈述 adj. 国家的；州的；正式的
friendly|友好的；亲切的；支持的；融洽的，和睦的 adv. 友善地；温和地 n. (Friendly)人名；(英)弗兰德利
forward|向前的；早的；迅速的 adv. 向前地；向将来 v. 促进；转寄；运送 n. 前锋
exchange|交换；交流；交易所；兑换 v. 交换；交易；兑换
suppose|假设；认为；让（虚拟语气）；推想 conj. 假使…结果会怎样
generous|慷慨的，大方的；宽宏大量的；有雅量的
hers|她的（所有格） n. (Hers)人名；(法)埃尔
explain|说明；解释
valid|有效的；有根据的；合法的；正当的
tie|系；约束；打结；与…成平局 n. 领带；平局；鞋带；领结；不分胜负
then|然后；那么；于是；当时；此外 n. 那时 conj. 然后，当时
sew|缝合，缝上；缝纫
desperate|不顾一切的；令人绝望的；极度渴望的
steak|牛排；肉排；鱼排
british|英国的；英国人的；大不列颠的 n. 英国人
sailor|水手，海员；乘船者
wear|衣物；磨损；耐久性 v. 穿着；用旧；耗损；面露
postage|邮资，邮费
presentation|展示；描述，陈述；介绍；赠送
wet|[气象][物] 潮湿的；有雨的 n. 雨天；湿气 v. 弄湿
avoid|避免；避开，躲避；消除
pity|怜悯，同情；遗憾 v. 对……表示怜悯；对……感到同情
arrangement|布置；整理；准备
among|在…中间；在…之中
author|作者；作家；创始人 v. 创作出版
mommy|妈咪
theft|盗窃；偷；赃物
bathe|沐浴；用水洗 n. 洗澡；游泳
assistant|助手，助理，助教 adj. 辅助的，助理的；有帮助的
battle|战役；斗争 v. 斗争；作战
beancurd|豆腐
front|前面；正面；前线 v. 面对；朝向；对付 adj. 前面的；正面的 adv. 在前面；向前
work|工作；[物] 功；产品；操作；职业；行为；事业；工厂；著作；文学、音乐或艺术作品 v. 使工作；操作；经营；使缓慢前进
blackboard|黑板
washroom|洗手间；盥洗室；厕所
legal|法律的；合法的；法定的；依照法律的 n. (Legal)人名；(法)勒加尔
fill|装满，使充满；满足；堵塞；任职 n. 满足；填满的量；装填物
crime|罪行，犯罪；罪恶；犯罪活动 vt. 控告……违反纪律
fifteen|十五；十五个；十五人组成的橄榄球队 adj. 十五的 num. 十五
indeed|的确；实在；真正地；甚至 int. 真的（表示惊讶、怀疑、讽刺等）
clever|聪明的；机灵的；熟练的
refuse|垃圾；废物 v. 拒绝；不愿；抵制
whichever|任何一个；无论哪个 adj. 无论哪个；无论哪些
leftover|残留物；吃剩的饭菜；剩余物 adj. 残余的；吃剩的
base|基础；底部；垒 adj. 卑鄙的；低劣的 v. 以…作基础
action|行动；活动；功能；战斗；情节
catholic|天主教的；宽宏大量的 n. 天主教徒；罗马天主教
succeed|成功；继承；继任；兴旺
track|轨道；足迹，踪迹；小道 v. 追踪；通过；循路而行；用纤拉
few|很少的；几乎没有的 pron. 很少 n. 很少数
city|城市，都市 adj. 城市的；都会的
sunday|星期日；礼拜日
pet|宠物；生气；受宠爱的人 v. 宠爱 adj. 宠爱的
into|到…里；深入…之中；成为…状况；进入到…之内 n. (Into)人名；(芬、英)因托
defeat|击败，战胜；挫败；使…失败 n. 失败的事实；击败的行为
teenager|十几岁的青少年；十三岁到十九岁的少年
jeep|吉普车
ample|丰富的；足够的；宽敞的 n. (Ample)人名；(西)安普尔
mirror|镜子；真实的写照；榜样 v. 反射；反映
typist|打字员，打字者
stadium|体育场；露天大型运动场
substitute|代用品；代替者 v. 替代
carve|雕刻；切开；开创 n. (Carve)人名；(西、瑞典)卡韦
electrical|有关电的；电气科学的
yell|大叫，叫喊 n. 喊声，叫声
wide|广泛的；宽的，广阔的；张大的；远离目标的 adv. 广泛地；广阔地；充分地 n. 大千世界
grape|葡萄；葡萄酒；葡萄树；葡萄色
resign|辞职；放弃；委托；使听从 n. 辞去职务
percentage|百分比；百分率，百分数
stout|结实的；矮胖的；勇敢的；激烈的 n. 矮胖子；烈性啤酒
final|最终的；决定性的；不可更改的 n. 决赛；期末考试；当日报纸的末版
certain|某一；必然的；确信；无疑的；有把握的 pron. 某些；某几个 n. (Certain)人名；(葡)塞尔塔因；(法)塞尔坦
discourage|阻止；使气馁
strict|严格的；绝对的；精确的；详细的
visual|视觉的，视力的；栩栩如生的
those|那些的 pron. 那些（that的复数）
needle|针；指针；刺激；针状物 v. 缝纫；做针线
car|汽车；车厢
put|放；表达；移动；安置；赋予 n. 掷；笨蛋；投击；怪人 adj. 固定不动的
circumstance|环境，情况；事件；境遇
without|没有；超过；在…外面 adv. 户外；在外面；没有或不显示某事物 n. 外部；外面
mend|修理，修补；改善；修改 n. 好转，改进；修补处
arithmetic|算术，算法
smart|聪明的；巧妙的；敏捷的；厉害的；潇洒的；剧烈的；时髦的 n. (Smart)人名；(法)斯马尔；(英、德)斯马特
fade|褪色；凋谢；逐渐消失 adj. 平淡的；乏味的 n. [电影][电视] 淡出；[电影][电视] 淡入
attain|达到，实现；获得；到达 n. 成就
greek|希腊语；希腊人 adj. 希腊的；希腊人的，希腊语的
smile|微笑 n. 微笑；笑容；喜色
eventually|最后，终于
fortune|财富；命运；运气 vt. 给予财富 vi. 偶然发生
purpose|目的；用途；意志 v. 决心；企图；打算
tense|紧张的；拉紧的 v. 变得紧张；使拉紧 n. 时态
bridge|桥；桥牌；桥接器；船桥 v. 架桥；渡过
lemonade|柠檬水
stranger|陌生人；外地人；局外人
liberate|解放；放出；释放
librarian|图书馆员；图书管理员
club|俱乐部，社团；夜总会；棍棒；（扑克牌中的）梅花 v. 用棍棒打；募集 adj. 俱乐部的
suspect|嫌疑犯 adj. 可疑的；不可信的 v. 怀疑；猜想
tin|锡；罐头，罐；马口铁 adj. 锡制的 v. 涂锡于；给…包马口铁
proper|适当的；本身的；特有的；正派的 adv. 完全地 n. (Proper)人名；(英、德)普罗珀
greeting|问候，招呼；祝贺 v. 致敬，欢迎（greet的现在分词）
discount|折扣；贴现率 v. 贴现；打折扣出售商品
delay|延期；耽搁 n. 延期；耽搁；被耽搁或推迟的时间
wheel|车轮；方向盘；转动 v. 转动；使变换方向；给…装轮子
time|时间；时代；次数；节拍；倍数 v. 计时；测定…的时间；安排…的速度 adj. 定时的；定期的；分期的
hit|打击；袭击；碰撞；偶然发现；伤…的感情 n. 打；打击；（演出等）成功；讽刺
leather|皮革；皮革制品 v. 用皮革包盖；抽打 adj. 皮的；皮革制的
correction|改正，修正
twelve|十二；十二个 num. 十二；十二个 adj. 十二的；十二个的
exact|准确的，精密的；精确的 v. 要求；强求；急需
it|[指无生命的东西、动物、植物]它；这；那 abbr. 信息技术information technology
fisherman|渔夫；渔人
know|知道；认识；懂得
pension|退休金，抚恤金；津贴；膳宿费 v. 发给养老金或抚恤金
ourselves|我们自己；我们亲自
eleven|十一；十一个 adj. 十一的；十一个的 num. 十一；十一个
let|允许，让；出租；假设；妨碍 n. 障碍；出租屋
good|好的；优良的；愉快的；虔诚的 n. 好处；善行；慷慨的行为 adv. 好
unfortunate|不幸的；令人遗憾的；不成功的
news|新闻，消息；新闻报导
watch|观察；注视；看守；警戒 n. 手表；监视；守护；值班人
agreement|协议；同意，一致
deposit|存款；押金；订金；保证金；沉淀物 v. 使沉积；存放
determine|（使）下决心，（使）做出决定
mexican|墨西哥的；墨西哥人的 n. 墨西哥人；墨西哥语
modem|调制解调器（等于modulator-demodulator）
salad|色拉；尤指莴苣
contrary|相反的；对立的 adv. 相反地 n. 相反；反面
education|教育；培养；教育学
cheer|欢呼；使高兴；为…加油 n. 欢呼；愉快；心情；令人愉快的事
shout|呼喊；喊叫；大声说 n. 呼喊；呼叫
pardon|原谅；赦免；宽恕 v. 原谅；赦免；宽恕
nice|精密的；美好的；细微的；和蔼的 n. (Nice)人名；(英)尼斯
purchase|购买；紧握；起重装置 v. 购买；赢得
owe|欠；感激；应给予；应该把……归功于 n. (Owe)人名；(瑞典、挪)奥弗
awake|觉醒，意识到；醒来；被唤起 adj. 醒着的
everywhere|到处 n. 每个地方
fair|公平的；美丽的，白皙的；[气象] 晴朗的 adv. 公平地；直接地；清楚地 v. 转晴 n. 展览会；市集；美人
ireland|爱尔兰
pick|挑选；采摘；挖 n. 选择；鹤嘴锄；挖；掩护
organiser|组织者；发起人；形成体（等于organizer）
young|年轻的；初期的；没有经验的 n. 年轻人；（动物的）崽，仔
chef|厨师，大师傅
roller|[机] 滚筒；[机] 滚轴；辊子；滚转机
weekend|周末，周末休假；周末聚会 adj. 周末的，周末用的 v. 度周末
video|[电子] 视频；录像，录像机；电视 adj. 视频的；录像的；电视的 v. 录制
appoint|任命；指定；约定
lady|女士，夫人；小姐；妻子
slice|薄片；部分；菜刀，火铲 v. 切下；把…分成部分；将…切成薄片
favour|偏爱；赞同；善行 v. 赞成；喜爱；有助于
arctic|北极的；极寒的 n. 北极圈；御寒防水套鞋
pulse|[电子] 脉冲；脉搏 v. 使跳动
tune|曲调；和谐；心情 v. 调整；使一致；为…调音
foreign|外国的；外交的；异质的；不相关的
funeral|葬礼；麻烦事 adj. 丧葬的，出殡的
compete|竞争；比赛；对抗
gallon|加仑（容量单位）
conduct|导电；带领 n. 进行；行为；实施
worth|值…的 n. 价值；财产
discovery|发现，发觉；被发现的事物
centre|以…为中心 n. 中心 adj. 中央的
abrupt|生硬的；突然的；唐突的；陡峭的
hot|热的；辣的；热情的；激动的；紧迫的 adv. 热；紧迫地 v. 变热 n. (Hot)人名；(塞)霍特；(法)奥特
solar|太阳的；日光的；利用太阳光的；与太阳相关的 n. 日光浴室
clothing|（总称）[服装] 服装；帆装 v. 覆盖（clothe的ing形式）；给…穿衣
emergency|紧急情况；突发事件；非常时刻 adj. 紧急的；备用的
abandon|放任；狂热 v. 遗弃；放弃
sheep|羊，绵羊；胆小鬼
computer|计算机；电脑；电子计算机
traditional|传统的；惯例的
plus|正号，加号；好处；附加额 adj. 正的；附加的 prep. 加，加上
band|带，环；[物] 波段；(演奏流行音乐的) 乐队 v. 用带绑扎；给镶边
document|文件，公文；[计] 文档；证件 v. 用文件证明
gate|大门；出入口；门道 v. 给…装大门
drum|击鼓；大力争取 n. 鼓；鼓声
library|图书馆，藏书室；文库
nutrition|营养，营养学；营养品
may|可以，能够；可能，也许；祝，愿；会，能
shake|动摇；摇动；震动；握手 n. 摇动；哆嗦
worthwhile|值得做的，值得花时间的
quilt|被子；棉被 v. 东拼西凑地编；加软衬料后缝制
myself|我自己；我亲自；我的正常的健康状况和正常情绪
tease|取笑；戏弄；梳理；欺负；强求；使起毛 n. 戏弄；爱纠缠的小孩；挑逗者；卖弄风骚的女孩
book|书籍；卷；帐簿；名册；工作簿 v. 预订；登记
modern|现代的，近代的；时髦的 n. 现代人；有思想的人
sorry|遗憾的；对不起的，抱歉的 int. 对不起，抱歉（表示委婉的拒绝等）
parallel|平行线；对比 v. 使…与…平行 adj. 平行的；类似的，相同的
evident|明显的；明白的
snack|小吃，快餐；一份，部分 v. 吃快餐，吃点心
possibly|可能地；也许；大概
your|你的，你们的
authority|权威；权力；当局
northern|北部的；北方的 n. 北部方言
by|通过；被；依据；经由；在附近；在……之前 adv. 通过；经过；附近；[互联网] 白俄罗斯的国家代码顶级域名
following|下面的；其次的，接着的 n. 下列事物；一批追随者 v. 跟随；沿行（follow的ing形式）
seashell|海贝，贝壳；海贝壳
pair|一对，一双，一副 v. 把…组成一对
explore|探索；探测；探险
partner|伙伴；合伙人；配偶 v. 合伙；合股；成为搭档
spread|传播；伸展 n. 传播；伸展 adj. 伸展的
swiss|瑞士的；瑞士人的；瑞士风格的 n. 瑞士人；瑞士腔调
microscope|显微镜
monument|纪念碑；历史遗迹；不朽的作品 vt. 为…树碑
slow|慢的；减速的；迟钝的 v. 变慢；变萧条 adv. 慢慢地；迟缓地 n. (Slow)人名；(英)斯洛
worse|更坏的；更差的；更恶劣的（bad的比较级）；（病情）更重的（ill的比较级） adv. 更糟；更坏；更恶劣地；更坏地 n. 更坏的事；更恶劣的事
particular|特别的；详细的；独有的；挑剔的 n. 详细说明；个别项目
bid|投标；出价；表示；吩咐 n. 出价；叫牌；努力争取
battery|[电] 电池，蓄电池
tape|胶带；磁带；带子；卷尺 v. 录音；用带子捆扎；用胶布把…封住
later|后来；稍后；随后 adj. 更迟的；更后的 n. (Later)人名；(德)拉特
envelope|信封，封皮；包膜；[天] 包层；包迹
short|短的；不足的；矮的，低的 n. 短；缺乏；短路；短裤 adv. 不足；突然；唐突地
insect|昆虫；卑鄙的人
might|力量；威力；势力 v. 可以；或许（may的过去式）；应该 aux. 可能；也许
zone|地带；地区；联防 v. 分成区
paint|油漆；绘画；装饰；涂色于；描绘；（用语言，文字等）描写；擦脂粉等 n. 油漆；颜料，涂料；绘画作品；胭脂等化妆品；色彩，装饰
spring|春天；弹簧；泉水；活力；跳跃 adj. 春天的 v. 生长；涌出；跃出；裂开
personally|亲自地；当面；个别地；就自己而言
directory|[计] 目录；工商名录；姓名地址录 adj. 指导的；咨询的
up|起来；上涨；向上 prep. 在…之上；向…的较高处 adj. 涨的；起床的；向上的 n. 上升；繁荣
warehouse|仓库；货栈；大商店 v. 储入仓库；以他人名义购进（股票）
freeway|高速公路
that|那；那个 adv. 那么；那样 conj. 因为；以至于 adj. 那；那个 n. (That)人名；(德)塔特
again|又，此外；再一次；再说；增加 n. （英、保）阿盖恩
digital|数字的；手指的 n. 数字；键
random|[数] 随机的；任意的；胡乱的 n. 随意 adv. 胡乱地
maximum|[数] 极大，最大限度；最大量 adj. 最高的；最多的；最大极限的
horse|马；骑兵；脚架；海洛因 v. 使骑马；系马于；捉弄
monkey|猴子；顽童 v. 胡闹；捣蛋
flight|飞行；班机；逃走 v. 射击；使惊飞
coin|铸造（货币）；杜撰，创造 n. 硬币，钱币
willingness|乐意；心甘情愿；自动自发
pork|猪肉 vt. 与女子性交
abolish|废除，废止；取消，革除
flood|淹没；充满；溢出 n. 洪水；泛滥；一大批
react|反应；影响；反抗；起反作用
offer|提供；出价；试图 n. 提议；出价；意图；录取通知书
bend|使弯曲；使屈服；使致力；使朝向 n. 弯曲
constant|不变的；恒定的；经常的 n. [数] 常数；恒量
guilty|有罪的；内疚的
web|网；卷筒纸；蹼；织物；圈套 v. 用网缠住；使中圈套
description|描述，描写；类型；说明书
fear|害怕；恐惧；敬畏；担心 v. 害怕；敬畏；为…担心
choose|选择，决定
prisoner|囚犯，犯人；俘虏；刑事被告
towel|毛巾，手巾；[纸] 纸巾 v. 用毛巾擦
tiny|微小的；很少的 n. (Tiny)人名；(葡、印)蒂尼
tension|张力，拉力；紧张，不安；电压 vt. 使紧张；使拉紧
cover|包括；采访，报导；涉及 n. 封面，封皮；盖子；掩蔽物;幌子，借口
tree|树；木料；树状物 v. 把赶上树
founding|创办的；发起的 v. [机] 铸造；建造；以…为基础（found的ing形式） n. [机] 铸造；溶解
wonderful|极好的，精彩的，绝妙的；奇妙的；美妙；胜；神妙
position|位置，方位；职位，工作；姿态；站位 v. 安置；把……放在适当位置
yard|院子；码（英制中丈量长度单位，1码=3英尺）；庭院；帆桁 vt. 把…关进或围在畜栏里
else|其他；否则；另外 adj. 别的；其他的 n. (Else)人名；(英)埃尔斯；(德)埃尔泽；(芬、丹)埃尔塞
expand|扩张；使膨胀；详述
mm|毫米（millimeter） n. 缅甸的域名
country|国家，国土；国民；乡下，农村；乡村；故乡 adj. 祖国的，故乡的；地方的，乡村的；国家的；粗鲁的；乡村音乐的
below|在下面，在较低处；在本页下面 prep. 在…下面 n. (Below)人名；(英、德、芬、瑞典)贝洛
press|压；按；逼迫；紧抱 n. 压；按；新闻；出版社；[印刷] 印刷机
saucer|茶托，浅碟；浅碟形物；眼睛
literature|文学；文献；文艺；著作
meanwhile|同时，其间 n. 其间，其时
ridiculous|可笑的；荒谬的
least|最小的；最少的（little的最高级） adv. 最小；最少 n. 最小；最少
packet|数据包，信息包；小包，小捆 vt. 包装，打包
failure|失败；故障；失败者；破产
apartment|公寓；房间
conscience|道德心，良心
running|运转；赛跑；流出 adj. 连续的；流动的；跑着的；运转着的 v. 跑；运转（run的ing形式）；行驶
worldwide|全世界的 adv. 在世界各地
on|向前地；作用中，行动中；继续着 prep. 向，朝……；关于；在……之上；在……时候 adj. 开着的；发生着的，正在进行中 n. (On)人名；(日)温(姓、名)；(缅、柬、印)翁
appendix|附录；阑尾；附加物
canada|加拿大（北美洲国家）
parent|父亲（或母亲）；父母亲；根源
kill|杀死；扼杀；使终止；抵消 n. 杀戮；屠杀 adj. 致命的；致死的
frighten|使惊吓；吓唬…
unsafe|不安全的；危险的；不安稳的
term|术语；学期；期限；条款；(代数式等的)项 v. 把…叫做
bureaucratic|官僚的；官僚政治的
gown|长袍，长外衣；礼服；睡袍；法衣 v. 使穿睡衣
crazy|疯狂的；狂热的，着迷的
outward|向外的；外面的；公开的；外服的；肉体的 adv. 向外（等于outwards）；在外；显而易见地 n. 外表；外面；物质世界
exploit|开发，开拓；剥削；开采 n. 勋绩；功绩
divide|划分；除；分开；使产生分歧 n. [地理] 分水岭，分水线
line|路线，航线；排；绳 v. 排成一行；划线于；以线条标示；使…起皱纹
bag|袋；猎获物；（俚）一瓶啤酒 v. 猎获；把…装入袋中；占据，私吞；使膨大
sail|航行；启航，开船 n. 帆，篷；航行
untrue|不真实的；不合标准的；不忠实的；不正当的
reading|阅读，朗读；读物；读数 adj. 阅读的 v. 阅读（read的ing形式）
toward|向；对于；为了；接近 adj. 即将来到的，进行中的 n. (Toward)人名；(英)特沃德
discrimination|歧视；区别，辨别；识别力
interval|间隔；间距；幕间休息
outgoing|对人友好的，开朗的；出发的，外出的；即将离职的；乐于助人的 n. 外出；流出；开支 v. 超过；优于（outgo的ing形式）
subtraction|[数] 减法；减少；差集
kid|小孩；小山羊 v. 欺骗；取笑；戏弄 adj. 小山羊皮制的；较年幼的
singer|歌手，歌唱家
hire|雇用，租用；租金，工钱 v. 雇用；出租
scottish|苏格兰的；苏格兰人的；苏格兰语的 n. 苏格兰人；苏格兰语
deadline|截止期限，最后期限
rob|抢劫；使…丧失；非法剥夺
april|四月
truck|卡车；交易；手推车 v. 驾驶卡车；以物易物 adj. （美）运货汽车的
gallery|画廊；走廊；旁听席；地道 vt. 在…修建走廊；在…挖地道 vi. 挖地道
stove|火炉；窑；温室 vt. 用火炉烤
pacific|太平洋的 n. 太平洋
ripen|使成熟
glad|高兴的；乐意的；令人高兴的；灿烂美丽的 vt. 使高兴 n. (Glad)人名；(塞、瑞典)格拉德；(英)格莱德；(法、挪)格拉
inch|英寸；身高；少许 v. 使缓慢地移动
teach|教；教授；教导 n. (Teach)人名；(英)蒂奇
sausage|香肠；腊肠；装香肠的碎肉
northeast|东北的；向东北的；来自东北的 n. 东北 adv. 向东北；来自东北
insurance|保险；保险费；保险契约；赔偿金
messy|凌乱的，散乱的；肮脏的，污秽的；麻烦的
countryside|农村，乡下；乡下的全体居民
teapot|茶壶
staff|职员；参谋；棒；支撑 adj. 职员的；行政工作的 v. 供给人员；给…配备职员
canteen|食堂，小卖部；水壶
touch|接触；触动；使轻度受害 n. 接触；触觉；格调；少许
are|是（be的第二人称单复数现在式） n. 公亩
fairness|公平；美好；清晰；顺利性
report|报告；报道；成绩单 v. 报告；报导；使报到
neck|脖子；衣领；海峡 v. 搂著脖子亲吻；变狭窄
member|成员；会员；议员
constitution|宪法；体制；章程；构造；建立，组成；体格
pass|及格；经过；护照；途径；传球 v. 经过；传递；变化；终止
medical|医学的；药的；内科的 n. 医生；体格检查
jam|果酱；拥挤；困境；扣篮 v. 使堵塞；挤进，使塞满；混杂；压碎
behalf|代表；利益
govern|管理；支配；统治；控制 n. (Govern)人名；(英)戈文
cross|交叉，十字；十字架，十字形物 v. 交叉；杂交；横过 adj. 交叉的，相反的；乖戾的；生气的
fifth|第五的；五分之一的 n. 第五；五分之一 num. 第五
dawn|黎明；开端 v. 破晓；出现；被领悟
diverse|不同的；多种多样的；变化多的
someone|有人，某人
skateboard|溜冰板 v. 用滑板滑行
wish|希望；祝福；心愿 v. 祝愿；渴望；向…致问候语
smell|嗅，闻；有…气味 n. 气味，嗅觉；臭味
matter|物质；事件 v. 有关系；要紧
barbecue|烤肉；吃烤肉的野宴 v. 烧烤；烤肉
aside|离开，撇开；在旁边 n. 旁白；私语，悄悄话；离题的话 prep. 在…旁边
appreciate|欣赏；感激；领会；鉴别
lake|湖；深红色颜料；胭脂红 vt. （使）血球溶解 vi. （使）血球溶解
my|我的 int. 哎呀（表示惊奇等）；喔唷 n. (My)人名；(越)美；(老、柬)米
plate|碟；金属板；金属牌；感光底片 v. 电镀；给…装甲
approximately|大约，近似地；近于
diet|饮食；食物；规定饮食 v. 节食
way|方法；道路；方向；行业；习惯 adv. 大大地；远远地 adj. 途中的
diamond|钻石，金刚石；菱形；方块牌 adj. 菱形的；金刚钻的
remain|保持；依然；留下；剩余；逗留；残存 n. 遗迹；剩余物，残骸
aircraft|飞机，航空器
curtain|幕；窗帘 v. 遮蔽；装上门帘
dig|挖，掘；探究 n. 戳，刺；挖苦
scotland|苏格兰
age|年龄；时代；寿命，使用年限；阶段 v. 成熟；变老
bamboo|竹，竹子 vt. 为…装上篾条 adj. 竹制的；土著居民的
arch|弓形，拱形；拱门 adj. 主要的 v. 使…弯成弓形；用拱连接
poet|诗人
fan|煽动；刺激；吹拂 n. 迷；风扇；爱好者
breast|乳房，胸部；胸怀；心情 v. 以胸对着；与…搏斗
sleeve|[机] 套筒，[机] 套管；袖子，[服装] 袖套 vt. 给……装袖子；给……装套筒
mentally|精神上，智力上；心理上
power|力量，能力；电力，功率；政权，势力；[数] 幂 v. 激励；供以动力；使…有力量 adj. 借影响有权势人物以操纵权力的
via|渠道，通过；经由
tick|标记号于；滴答地记录 n. 滴答声；扁虱；记号；赊欠
relax|放松，休息；松懈，松弛；变从容；休养
drawing|图画；牵引；素描术 v. 绘画；吸引（draw的ing形式）；拖曳
rough|粗糙的；粗略的；粗野的；艰苦的；未经加工的 v. 使粗糙；粗暴对待；草拟 n. 艰苦；高低不平的地面；未经加工的材料；粗糙的部分 adv. 粗糙地；粗略地；粗暴地
systematic|系统的；体系的；有系统的；[图情] 分类的；一贯的，惯常的
barber|为…理发；修整 n. 理发师
trouble|麻烦；烦恼；故障；动乱 v. 麻烦；使烦恼；折磨
male|男性的；雄性的；有力的 n. 男人；雄性动物
production|成果；产品；生产；作品
down|向下，下去；在下面 adj. 向下的 n. 软毛，绒毛；[地质] 开阔的高地 prep. 沿着，往下 v. 打倒，击败
liquid|液体的；清澈的；明亮的；易变的 n. 液体，流体；流音
adolescence|青春期
neighbour|n邻居;同胞；仁慈的人 v. 邻接 adj. 邻居的；邻近的
potential|潜能；可能性；[电] 电势 adj. 潜在的；可能的；势的
first|第一；首先；优先；宁愿 n. 第一；开始；冠军 adj. 第一的；基本的；最早的 num. 第一
diagram|图表；图解 v. 用图解法表示
memory|记忆，记忆力；内存，[计] 存储器；回忆
unhappy|不快乐的；不幸福的；不适当的
distant|遥远的；冷漠的；远隔的；不友好的，冷淡的
fence|栅栏；围墙；剑术 v. 防护；用篱笆围住；练习剑术
crowd|群众,一伙;一堆,许多,大众 v. 拥挤,挤满,挤进
function|功能；[数] 函数；职责；盛大的集会 v. 运行；活动；行使职责
bird|鸟；家伙；羽毛球 v. 向…喝倒彩；起哄
classify|分类；分等
explicit|明确的；清楚的；直率的；详述的
lightning|闪电的；快速的 n. 闪电 vi. 闪电
step|步，脚步；步骤；步伐；梯级 v. 踏，踩；走
jog|慢跑；轻推；蹒跚行进；使颠簸 n. 慢跑；轻推，轻撞
already|已经，早已；先前
night|夜晚，晚上；黑暗，黑夜 adj. 夜晚的，夜间的
drawer|抽屉；开票人；出票人；起草者；酒馆侍
wooden|木制的；僵硬的，呆板的
accessible|易接近的；可进入的；可理解的
passive|被动的，消极的；被动语态的 n. 被动语态
wonder|惊奇；奇迹；惊愕 v. 怀疑；想知道；惊讶 adj. 奇妙的；非凡的
ought|应该，应当；大概 vi. 应该，应当；大概
transform|改变，使…变形；转换
defend|辩护；防护
kilometre|[计量] 公里；[计量] 千米
talk|说；谈话；讨论 n. 谈话；演讲；空谈
girl|女孩；姑娘，未婚女子；女职员，女演员；（男人的）女朋友
ambassador|大使；代表；使节
grass|草；草地，草坪 v. 放牧；使……长满草；使……吃草
billion|十亿；大量 num. 十亿 adj. 十亿的
summary|简易的；扼要的 n. 概要，摘要，总结
moslem|穆斯林的；伊斯兰教的；回教的 n. 穆斯林；穆罕默德信徒；伊斯兰
wire|电线；金属丝；电报 v. 拍电报；给…装电线
morning|早晨；黎明；初期
depend|依赖，依靠；取决于；相信，信赖
fold|折叠；合拢；抱住；笼罩 n. 折痕；信徒；羊栏
precise|精确的；明确的；严格的
quick|核心；伤口的嫩肉 adj. 快的；迅速的，敏捷的；灵敏的 adv. 迅速地，快
conference|会议；讨论；协商；联盟；（正式）讨论会；[工会、工党用语]（每年的）大会 vi. 举行或参加（系列）会议
instead|代替；反而；相反
canadian|加拿大（人）的 n. 加拿大人
properly|适当地；正确地；恰当地
absolute|绝对的；完全的；专制的 n. 绝对；绝对事物
example|例子；榜样 vt. 作为…的例子；为…做出榜样 vi. 举例
bill|[法] 法案；广告；账单；[金融] 票据；钞票；清单 v. 宣布；开账单；用海报宣传
since|因为；由于；既然；自…以来；自…以后 prep. 自…以来；自…以后 adv. 后来
almost|差不多，几乎
marry|嫁；娶；与……结婚 n. (Marry)人名；(阿拉伯)马雷；(法)马里
adore|崇拜；爱慕；喜爱；极喜欢 n. (Adore)人名；(法)阿多尔
starvation|饿死；挨饿；绝食
handful|少数；一把；棘手事
porridge|粥，糊；麦片粥 vt. 服刑
jet|喷射，喷嘴；喷气式飞机；黑玉 adj. 墨黑的 v. 射出
volleyball|排球
draft|汇票；草稿；选派；（尤指房间、烟囱、炉子等供暖系统中的）（小股）气流 v. 起草；制定；征募 adj. 初步画出或（写出）的；（设计、草图、提纲或版本）正在起草中的，草拟的；以草稿形式的；草图的
festival|节日；庆祝，纪念活动；欢乐 adj. 节日的，喜庆的；快乐的
alarm|闹钟；警报，警告器；惊慌 v. 警告；使惊恐
sharp|急剧的；锋利的；强烈的；敏捷的；刺耳的 adv. 急剧地；锐利地；突然地 n. 尖头；骗子；内行 vt. 磨快；把音调升高 vi. 打扮；升音演奏
regular|定期的；有规律的；合格的；整齐的；普通的 n. 常客；正式队员；中坚分子 adv. 定期地；经常地
application|应用；申请；应用程序；敷用
republic|共和国；共和政体
rubbish|垃圾，废物；废话 adj. 毫无价值的
heavy|沉重的；繁重的，巨大的；拥挤的；阴沉的 n. 重物；严肃角色 adv. 大量地；笨重地
drown|淹没；把…淹死 n. (Drown)人名；(英)德朗
quality|质量，[统计] 品质；特性；才能 adj. 优质的；高品质的；<英俚>棒极了
catalogue|目录；（美）大学情况一览 v. 把…编入目录
cube|立方；立方体；骰子 v. 使成立方形；使自乘二次；量…的体积
wrinkle|皱纹 v. 起皱
bookshop|书店
eat|吃，喝；腐蚀；烦扰
egg|蛋；卵子；家伙；鸡蛋 v. 煽动；怂恿
highway|公路，大路；捷径
white|白色的；白种的；纯洁的 n. 白色；洁白；白种人
pencil|铅笔；笔状物 v. 用铅笔写；用眉笔涂
weigh|权衡；考虑；称…重量 n. 权衡；称重量
abuse|滥用；虐待；辱骂；弊端；恶习，陋习 v. 滥用；虐待；辱骂
tiger|老虎；凶暴的人
true|真实的；正确的 adv. 真实地；准确地 n. 真实；准确 v. 装准
eighty|八十；八十岁；八十年代 adj. 八十的，八十个的；八十岁的 num. 八十
sickness|疾病；呕吐；弊病
spiritual|圣歌（尤指美国南部黑人的） adj. 精神的，心灵的
i|我 n. 碘元素；英语字母I
blank|空白的；空虚的；单调的 n. 空白；空虚；空白表格 v. 使…无效；使…模糊；封锁
through|通过；穿过；凭借 adv. 彻底；从头至尾 adj. 直达的；过境的；完结的
boycott|联合抵制；拒绝参加 n. 联合抵制
harmony|协调；和睦；融洽；调和
aunt|阿姨；姑妈；伯母；舅妈
fuel|得到燃料 n. 燃料；刺激因素
paris|巴黎（法国首都）；帕里斯（特洛伊王子）
frost|结霜于；冻坏 n. 霜；冰冻，严寒；冷淡
central|中心的；主要的；中枢的 n. 电话总机
farmer|农夫，农民
vote|投票，选举；选票；得票数 v. 提议，使投票；投票决定；公认
ruin|废墟；毁坏；灭亡 v. 毁灭；使破产
england|英格兰
helmet|钢盔，头盔
the|这；那 adv. 更加（用于比较级，最高级前）
seaside|海边；海滨 adj. 海边的；海滨的
perfect|完美的；最好的；精通的 v. 使完美；使熟练 n. 完成式
airport|机场；航空站
flee|逃走；消失，消散
housewife|家庭主妇
fight|打架；与…打仗，与…斗争；反对…提案 n. 打架；战斗，斗志
piece|块；件；篇；硬币 v. 修补；接合；凑合
breath|呼吸，气息；一口气，（呼吸的）一次；瞬间，瞬息；微风；迹象；无声音，气音
ownership|所有权；物主身份
plane|飞机；平面；程度，水平 v. 刨；乘飞机旅行；翱翔 adj. 平的；平面的
fluent|流畅的，流利的；液态的；畅流的
gun|枪支；枪状物；持枪歹徒 v. 用枪射击；加大油门快速前进
indian|印度的；印第安人的；印第安语的 n. 印度人；印第安人；印第安语
bad|坏的；严重的；劣质的 n. 坏事；坏人 adv. 很，非常；坏地；邪恶地
boy|男孩；男人
howl|咆哮；怒吼；狂吠 n. 嗥叫；怒号；嚎哭
doll|洋娃娃；玩偶；无头脑的美丽女人 v. 把…打扮得花枝招展
yellow|黄色的；黄皮肤的 n. 黄色；黄种人；黄色颜料 v. 使变黄或发黄
settler|移居者；殖民者
unwilling|不愿意的；不情愿的；勉强的
bridegroom|新郎
favourite|特别受喜爱的 n. 特别喜爱的人（或物）
delicious|美味的；可口的
stage|阶段；舞台；戏剧；驿站 v. 举行；上演；筹划
academic|学术的；理论的；学院的 n. 大学生，大学教师；学者
rainbow|彩虹；五彩缤纷的排列；幻想 adj. 五彩缤纷的；彩虹状的 vt. 使呈彩虹状；如彩虹般装饰 vi. 呈彩虹状
interview|接见，采访；面试，面谈 v. 采访；接见；对…进行面谈；对某人进行面试
income|收入，收益；所得
flag|标记；衰退；枯萎 n. 标志；旗子
spaceship|[航] 宇宙飞船
deed|行动；功绩；证书；[法] 契据 vt. 立契转让
pain|疼痛；努力 v. 使…痛苦；使…烦恼
fox|欺骗；使变酸 n. 狐狸；狡猾的人
penny|（美）分；便士
around|大约；到处；在附近 prep. 四处；在…周围
grandma|奶奶；外婆
read|阅读；读懂，理解 n. 阅读；读物 adj. 有学问的
granddaughter|孙女；外孙女
trade|贸易，交易；行业；职业 v. 交易，买卖；以物易物
european|欧洲的；欧洲人的 n. 欧洲人
mat|垫；垫子；衬边 v. 缠结；铺席于……上 adj. 无光泽的
wine|酒，葡萄酒；紫红色 v. 喝酒
physician|[医] 医师；内科医师
hillside|山坡，山腹；山腰
britain|英国；不列颠
hero|英雄；男主角，男主人公
plan|计划；平面图 v. 计划；设计；打算
mourn|哀悼；忧伤；服丧
engineer|工程师；工兵；火车司机 v. 设计；策划；精明地处理
spend|度过，消磨（时光）；花费；浪费；用尽 n. 预算
bread|面包；生计 v. 在…上洒面包屑
interpreter|解释者；口译者；注释器
operate|运转；动手术；起作用
affect|影响；感染；感动；假装 n. 情感；引起感情的因素
bike|自行车；脚踏车 v. 骑自行车（或摩托车）
sacred|神的；神圣的；宗教的；庄严的
means|手段；方法；财产 v. 意思是；打算（mean的第三人称单数） [ 复数means ]
tire|疲劳；厌倦 n. 轮胎；头饰
marble|大理石；大理石制品；弹珠 adj. 大理石的；冷酷无情的
ferry|渡船；摆渡；渡口 v. （乘渡船）渡过；用渡船运送；空运
break|打破；折断；弄坏；削弱 n. 破裂；间断；（持续一段时间的状况的）改变；间歇
natural|自然的；物质的；天生的；不做作的 n. 自然的事情；白痴；本位音
letter|信；字母，文字；证书；文学，学问；字面意义 v. 写字母于
extreme|极端的；极度的；偏激的；尽头的 n. 极端；末端；最大程度；极端的事物
disappointment|失望；沮丧
kitchen|厨房；炊具；炊事人员
consideration|考虑；原因；关心；报酬
merchant|商人，批发商；店主 adj. 商业的，商人的
jewelry|珠宝；珠宝类
status|地位；状态；情形；重要身份
homework|家庭作业，课外作业
autumn|秋天；成熟期；渐衰期，凋落期 adj. 秋天的，秋季的
forever|永远；不断地；常常
selfish|自私的；利己主义的
athlete|运动员，体育家；身强力壮的人
before|在…之前，先于 adv. 以前；在前 conj. 在…以前；在…之前
itself|它自己；它本身
role|角色；任务
family|家庭；亲属；家族；子女；[生]科；语族；[化]族 adj. 家庭的；家族的；适合于全家的
victim|受害人；牺牲品；牺牲者
worm|虫，蠕虫；蜗杆；螺纹；小人物 v. 使蠕动；给除虫；使缓慢前进
shopkeeper|店主，老板
wedding|婚礼，婚宴；结婚；结合 v. 与…结婚（wed的ing形式）
classical|古典的；经典的；传统的；第一流的 n. 古典音乐
surplus|剩余；[贸易] 顺差；盈余；过剩 adj. 剩余的；过剩的
steep|陡峭的；不合理的；夸大的；急剧升降的 v. 泡；浸；使…充满 n. 峭壁；浸渍
woollen|羊毛制的 n. 毛织品
of|关于；属于；…的；由…组成的
fibre|纤维；纤维制品
tasteless|无味的；无鉴赏力的
dog|狗；丑女人；卑鄙的人；(俚)朋友 v. 跟踪；尾随
sensitive|敏感的；感觉的；[仪] 灵敏的；感光的；易受伤害的；易受影响的 n. 敏感的人；有灵异能力的人
junior|年少的；后进的；下级的 n. 年少者，晚辈；地位较低者；大学三年级学生
translator|译者；翻译器
adventure|冒险；冒险精神；投机活动 v. 冒险；大胆说出
qualification|资格；条件；限制；赋予资格
planet|行星
ugly|丑陋的；邪恶的；令人厌恶的
history|历史，历史学；历史记录；来历
house|住宅；家庭；机构；议会；某种用途的建筑物 v. 覆盖；给…房子住；把…储藏在房内
surface|表面；表层；外观 adj. 表面的，肤浅的 v. 浮出水面
devote|致力于；奉献
aid|援助；帮助；助手；帮助者 v. 援助；帮助；有助于
component|组成的，构成的 n. 成分；组件；[电子] 元件
generation|一代；产生；一代人；生殖
edge|边缘；优势；刀刃；锋利 v. 使锐利；将…开刃；给…加上边
organ|[生物] 器官；机构；风琴；管风琴；嗓音
federal|联邦的；同盟的；联邦政府的； 联邦制的 adv. 联邦政府地 n. (Federal)人名；(英)费德勒尔
alive|活着的；活泼的；有生气的
top|顶部，顶端；上部；首席；陀螺 v. 高出，超越；结束；达到顶点 adj. 最高的，顶上的；头等的
minority|少数民族；少数派；未成年 adj. 少数的；属于少数派的
have|有；让；拿；从事；允许 aux. 已经 n. (Have)人名；(芬)哈韦；(德)哈弗
notice|通知，布告；注意；公告 v. 通知；注意到；留心
tower|塔；高楼；堡垒 v. 高耸；超越
actress|女演员
enthusiastic|热情的；热心的；狂热的
loose|宽松的；散漫的；不牢固的；不精确的 v. 释放；开船；放枪 adv. 松散地 n. 放纵；放任；发射
adequate|充足的；适当的；胜任的
lock|锁，锁上；隐藏 n. 锁；水闸；刹车
blood|血，血液；血统 v. 从…抽血；使先取得经验
birthplace|出生地
navy|海军
american|美国人，美洲人；美国英语 adj. 美国的，美洲的；地道美国式的
problem|难题；引起麻烦的人 adj. 成问题的；难处理的
shall|应；会；将；必须
for|为，为了；因为；给；对于；至于；适合于 conj. 因为
cordless|不用电线的 adj. 无线的（副词cordlessly）
pleasure|快乐；希望；娱乐；令人高兴的事 vt. 使高兴；使满意 vi. 高兴；寻欢作乐
appointment|任命；约定；任命的职位
would|将，将要；愿意 v. will的过去式
grandchild|孙子；孙女；外孙；外孙女
window|窗；窗口；窗户
redirect|使改方向；重新寄送 adj. 再直接的 n. 再直接询问
niece|外甥女，侄女
coal|上煤；加煤 n. 煤；煤块；木炭
mainland|大陆；本土 adj. 大陆的；本土的
mother|母亲；大娘；女修道院院长 v. 生下；养育；像母亲般关怀或照管 adj. 母亲的；出生地的
chaos|混沌，混乱
polite|有礼貌的，客气的；文雅的；上流的；优雅的
entertainment|娱乐；消遣；款待
personnel|人事部门；全体人员 adj. 人员的；有关人事的
circle|循环，周期；圆；圈子；圆形物 v. 盘旋，旋转；环行
chinese|中文，汉语；中国人 adj. 中国的，中国人的；中国话的
monday|星期一
save|节省；保存；储蓄；解救 prep. 除之外 n. 救援
collar|衣领；颈圈 v. 抓住；给…上领子；给…套上颈圈
dot|点，圆点；嫁妆 v. 打上点
coach|教练；旅客车厢；长途公车；四轮大马车 v. 训练；指导
nuclear|原子能的；[细胞] 细胞核的；中心的；原子核的
voice|声音；嗓音；发言权；愿望 v. 表达；吐露
select|挑选；选拔 adj. 精选的；挑选出来的；极好的 n. 被挑选者；精萃
thunder|雷；轰隆声；恐吓 v. 打雷；怒喝
ancestor|始祖，祖先；被继承人
tend|趋向，倾向；照料，照顾
bowl|碗；木球；大酒杯 v. 玩保龄球；滑动；平稳快速移动
pretend|假装，伪装，佯装 adj. 假装的
majority|多数；成年
minute|分，分钟；片刻，一会儿；备忘录，笔记；会议记录 v. 将…记录下来 adj. 微小的，详细的 [maɪˈnjuːt; US -ˈnuːt; maɪˋnut]
weather|天气；气象；气候；处境 v. 经受住；使风化；侵蚀；使受风吹雨打 adj. 露天的；迎风的
suggestion|建议；示意；微量，细微的迹象
sunrise|日出；黎明
alike|相似的；相同的 adv. 以同样的方式；类似于
district|区域；地方；行政区
compulsory|义务的；必修的；被强制的 n. （花样滑冰、竞技体操等的）规定动作
tibet|西藏（中国一自治区）
lay|躺下；产卵；搁放；放置；铺放；涂，敷 adj. 世俗的；外行的；没有经验的 n. 位置；短诗；花纹方向；叙事诗；性伙伴
stomach|胃；腹部；胃口 v. 忍受；吃下
damage|损害；损毁；赔偿金 v. 损害；损毁
cough|咳嗽，咳嗽声；咳嗽病 v. 咳出
shut|关闭；停业；幽禁 n. 关闭 adj. 关闭的；围绕的
anniversary|周年纪念日
coat|外套 v. 覆盖…的表面
ham|火腿；业余无线电爱好者；蹩脚演员 v. 表演过火 adj. 过火的；做作的
depth|[海洋] 深度；深奥
somebody|大人物；重要人物 pron. 有人；某人
requirement|要求；必要条件；必需品
guard|守卫；警戒；护卫队；防护装置 v. 警惕
superman|超人，能力非凡的
artist|艺术家；美术家（尤指画家）；大师
prove|证明；检验；显示
cry|叫喊；哭出；大声说 n. 叫喊；叫声；口号；呼叫
lunch|午餐 v. 吃午餐；供给午餐
fourth|第四的，第四个的；四分之一的 n. 第四，月的第四日；四分之一 num. 第四
tractor|拖拉机；牵引机
entire|全部的，整个的；全体的 n. (Entire)人名；(英)恩泰尔
bare|空的；赤裸的，无遮蔽的 v. 露出，使赤裸 n. (Bare)人名；(英)贝尔
guess|猜测；认为；推测；猜中 n. 猜测；推测
outside|外面的，外部的；外来的 n. 外部；外观 adv. 在外面，向外面；在室外 prep. 在…范围之外
absent|缺席的；缺少的；心不在焉的；茫然的 v. 使缺席
firewood|柴火；木柴
our|我们的
iceland|冰岛（欧洲岛名，在大西洋北部，近北极圈）
ecology|生态学；社会生态学
religion|宗教；宗教信仰
participate|参与，参加；分享
unusual|不寻常的；与众不同的；不平常的
gravity|重力，地心引力；严重性；庄严
dust|灰尘；尘埃；尘土 v. 撒；拂去灰尘
science|科学；技术；学科；理科
money|钱；货币；财富
ship|运送，乘船；以船运送 n. 船；舰；太空船
precious|宝贵的；珍贵的；矫揉造作的 n. (Precious)人名；(英)普雷舍斯，普雷舍丝(女名)
today|今天；现今 n. 今天；现今
overlook|忽略；俯瞰；远眺；检查；高耸于…之上 n. 忽视；眺望
hang|悬挂，垂下；装饰；绞死；使悬而未决 n. 悬挂；暂停，中止
ticket|票；入场券，标签；（美）候选人名单；证明书；交通罚款单 v. 加标签于；指派；对…开出交通违规罚单
mosquito|蚊子
repairs|修理；[会计] 修理费；备件；修理工作（repair的复数形式） v. 修理；恢复（repair的三单形式）；弥补；纠正
dormitory|宿舍，学生宿舍 adj. 住宅区的
write|写，写字；写作，作曲；写信
seat|座位；所在地；职位 v. 使…坐下；可容纳…的；使就职
wander|徘徊；漫步；迷路；离题 n. (Wander)人名；(英)万德(女子教名)
tentative|试验性的，暂定的；踌躇的 n. 假设，试验
eighteen|十八，十八个 adj. 十八个的，十八的 num. 十八
hold|持有；拥有；保存；拘留；约束或控制 n. 控制；保留
habit|习惯，习性；嗜好 v. 使穿衣
future|未来；前途；期货；将来时 adj. 将来的，未来的
independent|独立的；单独的；无党派的；不受约束的 n. 独立自主者；无党派者
subject|主题；科目；[语] 主语；国民 adj. 服从的；易患…的；受制于…的 v. 使…隶属；使屈从于…
say|讲；说明；例如；声称；假设；指明 n. (Say)人名；(土)萨伊；(法、老、柬)赛；(英)塞伊；(匈、罗)绍伊
target|目标；靶子 v. 把……作为目标；规定……的指标；瞄准某物
disease|病，[医] 疾病；弊病 vt. 传染；使…有病
death|死；死亡；死神；毁灭
ago|以前，以往 adj. 以前的；过去的 n. (Ago)人名；(英、西、意、塞、瑞典)阿戈
shore|支撑，使稳住；用支柱撑住 n. 海滨；支柱
obey|服从，听从；按照……行动 n. (Obey)人名；(英、法)奥贝
thankful|感谢的；欣慰的
restaurant|餐馆；[经] 饭店
awesome|令人敬畏的；使人畏惧的；可怕的；极好的
decorate|装饰；布置；授勋给
judgement|意见；判断力；[法] 审判；评价
congratulation|祝贺；贺辞
appropriate|适当的；恰当的；合适的 v. 占用，拨出
assessment|评定；估价
supper|晚餐，晚饭；夜宵
bent|爱好，嗜好 adj. 弯曲的；决心的
they|他们；它们；她们
move|移动；步骤；迁居；策略 v. 移动；搬家，迁移；离开
eagle|鹰；鹰状标饰
common|共同的；普通的；一般的；通常的 n. 普通；平民；公有地
customer|顾客；家伙
cast|投，抛；计算；浇铸；投射（光、影、视线等） n. 投掷，抛；铸件，[古生] 铸型；演员阵容；脱落物
million|百万；无数 adj. 百万的；无数的 num. 百万
custom|习惯，惯例；风俗；海关，关税；经常光顾；[总称]（经常性的）顾客 adj. （衣服等）定做的，定制的
extra|特别地，非常；另外 n. 临时演员；号外；额外的事物；上等产品 adj. 额外的，另外收费的；特大的
ash|灰；灰烬
evaluate|评价；估价；求…的值
suit|适合；使适应 n. 诉讼；恳求；套装，西装；一套外衣
servant|仆人，佣人；公务员；雇工
wednesday|星期三
after|后来，以后 prep. 在……之后 conj. 在……之后 adj. 以后的
attempt|企图，试图；攻击 v. 企图，试图；尝试
retire|退休；撤退；退却 n. 退休；退隐；退兵信号
return|返回；报答 n. 返回；归还；回球 adj. 报答的；回程的；返回的
celebrate|庆祝；举行；赞美；祝贺；宣告
switch|转换；用鞭子等抽打 n. 开关；转换；鞭子
cure|治疗；治愈；使硫化；加工处理 n. 治疗；治愈；[临床] 疗法
primary|主要的；初级的；基本的 n. 原色；最主要者
keep|保持；经营；遵守；饲养 n. 保持；生计；生活费
pyramid|金字塔；角锥体 v. 渐增；上涨；成金字塔状
afford|给予，提供；买得起 n. (Afford)人名；(英)阿福德
cut|伤口；切口；削减；（服装等的）式样；削球；切入 v. [机] 切割；削减；缩短；刺痛 adj. 割下的；雕过的；缩减的
ban|禁止，取缔 n. 禁令，禁忌
tablet|碑；药片；写字板；小块；平板电脑 vt. 用碑牌纪念；将(备忘录等)写在板上；将…制成小片或小块
head|头；头痛；上端；最前的部分；理解力 v. 前进；用头顶；作为…的首领；站在…的前头；给…加标题 adj. 头的；主要的；在顶端的
foreigner|外地人，外国人
willing|乐意的；自愿的；心甘情愿的 v. 决心；用意志力驱使；将（财产等）遗赠某人（will的现在分词） n. (Willing)人名；(德、芬、瑞典)维林；(英)威林
mineral|矿物；（英）矿泉水；无机物；苏打水（常用复数表示） adj. 矿物的；矿质的
shade|树荫；阴影；阴凉处；遮阳物；（照片等的）明暗度；少量、些微；细微的差别 v. 使阴暗；使渐变；为…遮阳；使阴郁；掩盖
various|各种各样的；多方面的
poem|诗
above|超过；在……上面；在……之上 adv. 在上面；在上文 adj. 上文的 n. 上文
dinosaur|恐龙；过时、落伍的人或事物
valuable|有价值的；贵重的；可估价的 n. 贵重物品
swallow|忍受；吞没 n. 燕子；一次吞咽的量
blue|蓝色；[复数]（美国海、陆、空三军穿的）蓝色制服；蓝颜料；[the blue(s)][用作单数或复数]布鲁斯（歌曲）（一种伤感的美国黑人民歌 adj. 蓝色的；沮丧的，忧郁的；下流的 v. 把…染成蓝色；使成蓝色；给…用上蓝剂；用上蓝剂于
teamwork|团队合作；协力
wax|蜡；蜡状物 v. 给…上蜡 adj. 蜡制的；似蜡的
tyre|装轮胎于 n. [橡胶] 轮胎；轮箍
hour|小时；钟头；课时；…点钟
battleground|战场
sometimes|有时，间或
mud|弄脏；用泥涂 n. 泥；诽谤的话；无价值的东西
office|办公室；政府机关；官职；营业处
leg|腿；支柱
melon|瓜；甜瓜；大肚子；圆鼓鼓像瓜似的东西
race|属，种；种族，人种；家庭，门第 v. 使参加比赛；和…竞赛；使急走，使全速行进
optional|可选择的，随意的 n. 选修科目
stop|停止；堵塞；断绝 n. 停止；车站；障碍；逗留
dustbin|垃圾箱；吃货
screen|屏，幕；屏风 v. 筛；拍摄；放映；掩蔽
stocking|长袜
flat|平的；单调的；不景气的；干脆的；平坦的；扁平的；浅的 adv. （尤指贴着另一表面）平直地；断然地；水平地；直接地，完全地 n. 平地；公寓；平面 vt. 使变平；[音乐]使（音调）下降，尤指降半音 vi. 逐渐变平；[音乐]以降调唱（或奏）
alone|独自的；单独的；孤独的 adv. 独自地；单独地
print|印刷业；印花布；印刷字体；印章；印记 v. 印刷；打印；刊载；用印刷体写；在…印花样
die|死亡；凋零；熄灭 n. 冲模，钢模；骰子
mouse|鼠标；老鼠；胆小羞怯的人 v. 探出
space|空间；太空；距离 v. 留间隔
early|早期的；早熟的 adv. 提早；在初期 n. (Early)人名；(英)厄尔利
athletic|运动的，运动员的；体格健壮的
cubic|立方体的，立方的 n. (Cubic)人名；(罗)库比克
secret|秘密；秘诀；机密 adj. 秘密的；机密的
bush|灌木；矮树丛 v. 以灌木装饰；使…精疲力竭 adj. 如灌木般长得低矮的；粗野的
calculate|计算；以为；作打算
super|特级的；极好的 n. 特级品，特大号；临时雇员
people|人；人类；民族；公民 v. 居住于；使住满人
brake|刹车 n. 闸，刹车；阻碍
side|方面；侧面；旁边 v. 支持；赞助；偏袒 adj. 旁的，侧的
safety|安全；保险；安全设备；保险装置；安打
snowball|雪球 v. 掷雪球；滚雪球般增大
address|演说；从事；忙于；写姓名地址；向…致辞；与…说话；提出；处理 n. 地址；演讲；致辞；说话的技巧；称呼
store|商店；储备，贮藏；仓库 v. 贮藏，储存
institution|制度；建立；（社会或宗教等）公共机构；习俗
neat|灵巧的；整洁的；优雅的；齐整的；未搀水的；平滑的
laughter|笑；笑声
schoolbag|书包
clap|鼓掌，拍手；啪地关上 n. 鼓掌；拍手声
wall|墙壁，围墙；似墙之物 v. 用墙围住，围以墙 adj. 墙壁的
duck|鸭子；鸭肉；（英）宝贝儿；零分 v. 闪避；没入水中
download|[计] 下载
pine|渴望，痛苦；憔悴 n. [林] 松树；凤梨，菠萝 adj. 松木的；似松的
agree|同意，赞成；承认；约定，商定
remember|记得；牢记；纪念；代…问好
large|大的；多数的；广博的 adv. 大大地；夸大地 n. 大
curious|好奇的，有求知欲的；古怪的；爱挑剔的
day|一天；时期；白昼 adv. 每天；经常在白天地 adj. 日间的；逐日的
motorcycle|摩托车；机动车 v. 骑摩托车
jeans|牛仔裤；工装裤
busy|忙碌的；热闹的；正被占用的 v. 使忙于 n. (Busy)人名；(匈)布希；(法)比西
astonish|使惊讶
cotton|棉花；棉布；棉线 v. 一致；理解；和谐；亲近 adj. 棉的；棉制的
tax|向…课税；使负重担 n. 税金；重负
juicy|多汁的；利润多的；生动的
apply|申请；涂，敷；应用
aggressive|侵略性的；好斗的；有进取心的；有闯劲的
canal|运河；[地理] 水道；[建] 管道；灌溉水渠 v. 在…开凿运河
achieve|取得；获得；实现；成功
straight|直的；连续的；笔直的；正直的；整齐的；异性恋的 adv. 直接地；不断地；立即；坦率地 n. 直；直线；直男，直女，异性恋者
shoulder|肩，肩膀；肩部 v. 肩负，承担
bitter|苦的；痛苦的；尖刻的；充满仇恨的 n. 苦味；苦啤酒 adv. 激烈地；严寒刺骨地 v. 使变苦
growth|增长；发展；生长；种植
volunteer|志愿者；志愿兵 adj. 志愿的 v. 自愿
lip|嘴唇；边缘 vt. 以嘴唇碰 adj. 口头上的 vi. 用嘴唇
representative|典型的，有代表性的；代议制的 n. 代表；典型；众议员
same|相同的；同一的；上述的（通常与the连用）；无变化的 pron. 同样的事物或人（通常与the连用） adv. 同样地（通常与the连用） n. (Same)人名；(意)萨梅
southern|南的；南方的 n. 南方人
daylight|白天；日光；黎明；公开
symphony|交响乐；谐声，和声
watermelon|西瓜
smoking|抽烟；冒气 adv. 冒着烟 adj. 准许吸烟的 v. 吸烟；冒烟（smoke的现在分词）
clinic|临床；诊所
model|模型；典型；模范；模特儿；样式 v. 模拟；塑造；模仿 adj. 模范的；作模型用的
partly|部分地；在一定程度上
painter|画家；油漆匠
purse|(女士)手提袋；(国家、家庭、团体等的) 财力 v. （嘴巴）皱起，使缩拢；撅嘴
characteristic|典型的；特有的；表示特性的 n. 特征；特性；特色
skin|皮肤；外皮 v. 剥皮
train|火车；行列；长队；裙裾 v. 培养；训练；瞄准
vivid|生动的；鲜明的；鲜艳的
operation|操作；经营；[外科] 手术；[数][计] 运算
check|检查，核对；制止，抑制；在…上打勾 n. <美>支票；制止，抑制；检验，核对
alcoholic|酒精的，含酒精的 n. 酒鬼，酗酒者
button|按钮；纽扣 v. 扣住；扣紧；在…上装纽扣
salesgirl|女售货员，女店员
roast|烤，焙；烘，烘烤；暴露于某种热力下以得温暖 adj. 烘烤的；烤过的 n. 烤肉；烘烤
communist|共产党员；共产主义者 adj. 共产主义的
give|给；产生；让步；举办；授予 n. 弹性；弯曲；伸展性
scar|伤害；给留下伤痕 n. 创伤；伤痕
found|创立，建立；创办
handkerchief|手帕；头巾，围巾
acquisition|获得物，获得；收购
cloth|布；织物；桌布 adj. 布制的
single|单一的；单身的；单程的 n. 一个；单打；单程票 v. 选出
latter|后者的；近来的；后面的；较后的 n. (Latter)人名；(英、德、捷)拉特
patient|有耐心的，能容忍的 n. 病人；患者
mexico|墨西哥
paperwork|文书工作
appetite|食欲；嗜好
dish|盘；餐具；一盘食物；外貌有吸引力的人 v. 盛于碟盘中；分发；使某人的希望破灭；说（某人）的闲话
tap|轻敲；轻打；装上嘴子 n. 水龙头；轻打
buddhism|佛教
come|来；开始；出现；发生；变成；到达 int. 嗨！ n. (Come)人名；(英)科姆；(阿尔巴)乔梅
university|大学；综合性大学；大学校舍
bed|床；基础；河底， 海底 v. 使睡觉；安置，嵌入；栽种
egypt|埃及（非洲国家）
necklace|项链
unemployment|失业；失业率；失业人数
football|足球，橄榄球 vi. 踢足球；打橄榄球
ahead|向前；在前的；领先 adv. 向前地；领先地；在（某人或某事物的）前面；预先；在将来，为未来
impression|印象；效果，影响；压痕，印记；感想；曝光（衡量广告被显示的次数。打开一个带有该广告的网页，则该广告的impression 次数增加一次）
buy|购买；获得；贿赂 n. 购买，买卖；所购的物品
spit|吐痰；吐口水；发出劈啪声 n. 唾液
across|穿过；横穿 adv. 横过；在对面
no|不 adj. 没有；不是 n. 不；否决票 abbr. 数字（number）；元素锘（nobelium）的符号
announce|宣布；述说；预示；播报
fare|经营；进展；遭遇；过活 n. 票价；费用；旅客；食物
possible|可能的；合理的；合适的 n. 可能性；合适的人；可能的事物
bay|海湾；狗吠声 v. 向…吠叫
quarter|四分之一；地区；季度；一刻钟；两角五分；节 v. 住宿；驻扎 num. 四分之一
bang|刘海；重击；突然巨响 adv. 直接地；砰然地；突然巨响地 v. 重击；发巨响
stubborn|顽固的；顽强的；难处理的
extremely|非常，极其；极端地
cost|花费；使付出；使花许多钱 n. 费用，代价，成本；损失
cheese|[食品] 奶酪；干酪；要人 v. 停止 adj. 叛变的；胆小的
straightforward|简单的；坦率的；明确的；径直的 adv. 直截了当地；坦率地
traveler|旅行者；旅客；旅行推销员（等于traveller）
international|国际组织；国际体育比赛；外国居留者；国际股票 adj. 国际的；两国（或以上）国家的；超越国界的；国际关系的；世界的
acute|严重的，[医] 急性的；敏锐的；激烈的；尖声的
gentle|温和的；文雅的 v. 使温和，使驯服 n. 蛆，饵
imagine|想像；猜想；臆断
raincoat|（美）雨衣
humorous|诙谐的，幽默的；滑稽的，可笑的
gruel|使极度疲劳；累垮 n. 稀粥
fine|好的；优良的；细小的，精美的；健康的；晴朗的 n. 罚款 v. 罚款；澄清 adv. 很好地；精巧地
quit|离开；放弃；停止；使…解除 n. 离开；[计] 退出 adj. 摆脱了…的；已经了结的
ant|蚂蚁
squeeze|挤；紧握；勒索 n. 压榨；紧握；拥挤；佣金
elephant|象；大号图画纸
pest|害虫；有害之物；讨厌的人
separate|使分离；使分开；使分居 adj. 单独的；分开的；不同的；各自的； n. 分开；抽印本
telegram|电报 vt. 用电报发送 vi. 发电报
pronounce|发音；宣判；断言
electronic|电子的 n. 电子电路；电子器件
jump|跳跃；暴涨；惊跳 v. 跳跃；使跳跃；跳过；突升
lot|份额；许多；命运；阄 adv. （与形容词和副词连用）很，非常；（与动词连用）非常 pron. 大量，许多 v. 分组，把…划分（常与out连用）；把（土地）划分成块
deliberately|故意地；谨慎地；慎重地
sculpture|雕塑；雕刻；刻蚀 v. 雕塑；雕刻；刻蚀
steal|剽窃；偷偷地做；偷窃 n. 偷窃；便宜货；偷垒；断球
miniskirt|超短裙；迷你短裙
research|研究；调查 v. 研究；调查
refrigerator|冰箱，冷藏库
round|圆；循环；一回合；圆形物 adj. 圆的；完全的；大概的；肥胖的 adv. 在周围；迂回地；朝反方向；挨个 v. 完成；围捕；绕行；弄圆 prep. 附近；绕过；大约；在…周围
casual|随便的；非正式的；临时的；偶然的 n. 便装；临时工人；待命士兵
cancel|取消；删去 n. 取消，撤销
he|男孩，男人；它（雄性动物） pron. 他
colleague|同事，同僚
whether|是否；不论 pron. 两个中的哪一个
live|活的；生动的；实况转播的；精力充沛的 v. 经历；度过 n. (Live)人名；(法)利夫
beyond|超过；越过；那一边；在较远的一边 adv. 在远处；在更远处 n. 远处
ill|生病的；坏的；邪恶的；不吉利的 adv. 不利地；恶劣地；几乎不 n. 疾病；不幸
skate|滑冰；滑过 n. 溜冰；冰鞋
herb|香草，药草
recent|最近的；近代的
discuss|讨论；论述，辩论
silent|沉默的；寂静的；无记载的 n. 无声电影
kind|种类；性质 adj. 和蔼的；宽容的；令人感激的
badly|非常，很；严重地，厉害地；恶劣地
contradictory|矛盾的；反对的；反驳的；抗辩的 n. 对立物；矛盾因素
shower|淋浴；（倾泻般出现的）一阵，一大批；阵雨 v. 大量地给予；把……弄湿
aspect|方面；方向；形势；外貌
decade|十年，十年期；十
distance|距离；远方；疏远；间隔 v. 疏远；把…远远甩在后面
zipper|拉链 v. 拉上拉链
permanent|永久的，永恒的；不变的 n. 烫发（等于permanent wave）
honour|荣誉；尊敬；勋章 v. 尊敬；[金融] 承兑；承兑远期票据
political|政治的；党派的
organise|组织起来；组织工会
driver|驾驶员；驱动程序；起子；传动器
complete|完整的；完全的；彻底的 v. 完成
nowhere|无处；任何地方都不；毫无结果 n. 无处；任何地方；无名之地 adj. 不存在的；毫无结果的；不知名的
shop|商店；店铺 v. 购物
gradually|逐步地；渐渐地
shaver|理发师；电动剃刀
virus|[病毒] 病毒；恶毒；毒害
disk|[计] 磁盘，磁碟片；圆盘，盘状物；唱片
loaf|条，一条面包；块；游荡 v. 游荡；游手好闲；虚度光阴
arrest|逮捕；阻止；吸引 n. 逮捕；监禁
square|平方的；正方形的；直角的；正直的 v. 使成方形；与…一致 n. 平方；广场；正方形 adv. 成直角地
justice|司法，法律制裁；正义；法官，审判员
dr|速度三角形定位法（dead reckoning）；数据记录器（Data Recorder）
world|世界；领域；世俗；全人类；物质生活
if|（表条件）如果；即使；是否；（表假设）假如 n. 条件；设想
dirt|污垢，泥土；灰尘，尘土；下流话
procedure|程序，手续；步骤
mix|配制；混淆；使混和；使结交 n. 混合；混合物；混乱
strong|坚强的；强壮的；牢固的；擅长的 adv. 强劲地；猛烈地 n. (Strong)人名；(英)斯特朗
fact|事实；实际；真相
kilo|千克
scientific|科学的，系统的
feed|喂养；供给；放牧；抚养（家庭等）；靠…为生 n. 饲料；饲养；（动物或婴儿的）一餐
category|种类，分类；[数] 范畴
dead|无生命的；呆板的；废弃了的 adv. 完全地 n. 死者
against|反对，违反；靠；倚；防备 adj. 不利的；对立的
corrupt|腐败的，贪污的；堕落的 v. 使腐烂；使堕落，使恶化
laugh|笑；引人发笑的事或人 v. 笑
airspace|空域；领空；空间
vanilla|香子兰，香草 adj. 香草味的
hammer|锤击；敲打；重复 n. 铁锤；链球；[解剖] 锤骨；音锤
perfume|香水；香味 v. 洒香水于…；使…带香味
whose|谁的（疑问代词）
necktie|领带
bury|埋葬；隐藏 n. (Bury)人名；(法)比里；(英、西)伯里；(德、意、罗、波、捷、匈)布里；(俄)布雷
cabbage|卷心菜，甘蓝菜，洋白菜；（俚)脑袋；（非正式、侮辱）植物人（常用于英式英语）；（俚）钱，尤指纸币（常用于美式俚语）
shortcoming|缺点；短处
salt|盐；风趣，刺激性 adj. 咸水的；含盐的，咸味的；盐腌的；猥亵的 v. 用盐腌；给…加盐；将盐撒在道路上使冰或雪融化
seventy|七十；七十个；七十岁；七十年代 adj. 七十的；七十个的；七十岁的 num. 七十
length|长度，长；时间的长短；（语）音长
worst|最差的，最坏的；最不利的；效能最低的 n. 最坏；最坏的时候 adv. 最坏地；最不利地
audience|观众；听众；读者；接见；正式会见；拜会
measure|测量；措施；程度；尺寸 v. 测量；估量；权衡
outline|轮廓；大纲；概要；略图 v. 概述；略述；描画…轮廓
bathroom|浴室；厕所；盥洗室
height|高地；高度；身高；顶点
prairie|大草原；牧场
balance|平衡；余额；匀称 v. 使平衡；结算；使相称
blind|盲目的；瞎的 adv. 盲目地；看不见地 n. 掩饰，借口；百叶窗 v. 使失明；使失去理智
portable|手提的，便携式的；轻便的 n. 手提式打字机
row|行，排；划船；街道；吵闹 v. 划船；使……成排
truly|真实地，不假；真诚地 n. (Truly)人名；(英)特鲁利
downward|向下的，下降的 adv. 向下
accent|口音；重音；强调；特点；重音符号 v. 强调；重读；带…口音讲话
basket|篮子；（篮球比赛的）得分；一篮之量；篮筐 vt. 装入篮
shave|剃须，剃毛 n. 刮脸，剃胡子；修面；<口>侥幸逃过，幸免；剃刀，刮刀
outer|外面的，外部的；远离中心的 n. 环外命中
note|笔记；音符；票据；注解；纸币；便笺；照会；调子 v. 注意；记录；注解
ottawa|渥太华（加拿大首都）
smoker|吸烟者；薰制工
drag|拖累；拖拉；缓慢而吃力地行进 n. 拖；拖累
unite|使…混合；使…联合；使…团结
spain|西班牙
postcode|（英）邮政编码；邮区号
confident|自信的；确信的
website|网站（全球资讯网的主机站）
swell|膨胀；肿胀；隆起 n. 肿胀；隆起 adj. 漂亮的；一流的
medicine|药；医学；内科；巫术 v. 用药物治疗；给…用药
set|[数] 集合；一套；布景；[机] 装置 v. 树立；点燃；点缀； adj. 固定的；规定的；固执的
comb|梳子；蜂巢；鸡冠 v. 梳头发；梳毛
sale|销售；出售；拍卖；销售额；廉价出售
immigration|外来移民；移居
process|处理；加工 n. 过程，进行；方法，步骤；作用；程序；推移 adj. 经过特殊加工（或处理）的
east|东方；东风；东方国家 adj. 东方的；向东的；从东方来的 adv. 向东方，在东方
hurry|匆忙，急忙 v. 仓促（做某事）；催促；（朝某方向）迅速移动；迅速处理
how|如何；多少；多么 n. 方法；方式 conj. 如何
beast|野兽；畜生，人面兽心的人
practice|实践；练习；惯例 v. 练习；实习；实行
reliable|可靠的；可信赖的 n. 可靠的人
evening|晚上；傍晚；（联欢性的）晚会；后期 adj. 在晚上的；为晚上的；晚上用的 int. 晚上好（等于good evening）
allocate|分配；拨出；使坐落于
development|发展；开发；发育；住宅小区（专指由同一开发商开发的）；[摄] 显影
paragraph|段落；短评；段落符号 v. 将…分段
terminal|末端；终点；终端机；极限 adj. 末端的；终点的；晚期的
correspond|符合，一致；相应；通信
war|战争，斗争；军事，战术；冲突，对抗，竞争 v. 打仗，作战；对抗
sleepy|欲睡的；困乏的；不活跃的
surprise|惊奇，诧异；突然袭击 v. 使惊奇；奇袭 adj. 令人惊讶的
snowman|雪人
search|搜寻；调查；探求 n. 搜寻；探究，查究
toothache|[口腔] 牙痛
wash|洗涤；洗的衣服；化妆水；冲积物 v. 洗涤；洗刷；冲走；拍打
classroom|教室
nephew|侄子；外甥
cap|盖；帽子 v. 脱帽致意
aggression|侵略；进攻；侵犯；侵害
tv|电视（television）
notebook|笔记本，笔记簿；手册
bonus|奖金；红利；额外津贴
drop|滴；使降低；使终止；随口漏出 n. 滴；落下；空投；微量；滴剂
circus|马戏；马戏团
amount|总计，合计；相当于；共计；产生…结果 n. 数量；总额，总数
bounce|跳；弹力；活力 v. 弹跳；使弹起
married|已婚的，有配偶的；婚姻的，夫妇的；密切结合的 n. 已婚者 v. 结婚，与…结婚（marry的过去式）
none|没有人；一个也没有；没有任何东西 adj. 没有的，一点没有的 adv. 决不，一点也不 n. (None)人名；(葡、罗)诺内；(日)野根(姓)
arrive|到达；成功；达成；出生 n. (Arrive)人名；(法)阿里夫
steady|稳定的；不变的；沉着的 v. 稳固 adv. 稳定地；稳固地 n. 关系固定的情侣；固定支架
museum|博物馆
enjoyable|快乐的；有乐趣的；令人愉快的
headache|头痛；麻烦；令人头痛之事
hopeful|有希望的；有前途的 n. 有希望成功的人
event|事件，大事；项目；结果
ache|疼痛；渴望 n. 疼痛
heavily|沉重地；猛烈地；沉闷地
warning|警告；预兆；预告 adj. 警告的；引以为戒的 v. 警告（warn的ing形式）
form|形式，形状；形态，外形；方式；表格 v. 构成，组成；排列，组织；产生，塑造
outspoken|坦率的，直言不讳的
hungry|饥饿的；渴望的；荒年的；不毛的
ton|吨；很多，大量
afraid|害怕的；恐怕；担心的
salty|咸的；含盐的
need|需要，要求；缺乏；必要之物 v. 需要
rugby|英式橄榄球；拉格比（英格兰中部的城市）
lamb|羔羊，小羊；羔羊肉 v. 生小羊，产羔羊
cream|奶油，乳脂；精华；面霜；乳酪
fond|喜欢的；温柔的；宠爱的 n. (Fond)人名；(法)丰；(瑞典)丰德
recite|背诵；叙述；列举
disobey|违反；不服从
leader|领导者；首领；指挥者
fun|乐趣；玩笑；有趣的人或事 adj. 供娱乐用的 vi. 开玩笑
vain|徒劳的；自负的；无结果的；无用的
service|服务，服侍；服役；仪式 adj. 服务性的；耐用的；服现役的 v. 维修，检修；保养
stainless|不锈的；纯洁的，未被玷污的；无瑕疵的
agent|代理人，代理商；药剂；特工 vt. 由…作中介；由…代理 adj. 代理的
maid|女仆；少女 vt. 侍候；做新娘的女傧相 vi. 当女仆
camera|照相机；摄影机
too|太；也；很；还；非常；过度
nine|九，九个 num. 九；九个 adj. 九的，九个的
perform|执行；完成；演奏
doubt|怀疑；疑问；疑惑 v. 怀疑；不信；恐怕；拿不准
digest|消化；吸收；融会贯通 n. 文摘；摘要
while|虽然；然而；当……的时候 n. 一会儿；一段时间 v. 消磨；轻松地度过
pretty|漂亮的；可爱的；优美的 adv. 相当地；颇 n. 有吸引力的事物（尤指饰品）；漂亮的人
studio|工作室；[广播][电视] 演播室；画室；电影制片厂
moscow|莫斯科（俄罗斯首都）
disturbing|令人不安的；烦扰的 v. 干扰；打断（disturb的ing形式）
schoolmate|同学；同窗
adult|成年的；成熟的 n. 成年人
miss|女士，小姐，年轻未婚女子
hobby|嗜好；业余爱好
disagree|不同意；不一致；争执；不适宜
bound|有义务的；必定的；受约束的；装有封面的 v. 束缚；使跳跃 n. 范围；跳跃
approve|批准；赞成；为…提供证据
convenience|便利；厕所；便利的事物
who|谁；什么人
arm|手臂；武器；袖子；装备；部门 v. 武装起来
goods|商品；动产；合意的人；真本领
butterfly|蝴蝶；蝶泳；举止轻浮的人；追求享乐的人
risk|风险；危险；冒险 v. 冒…的危险
african|非洲的，非洲人的 n. 非洲人
twentieth|二十分之一 adj. 第二十的；二十分之一的 num. 第二十
america|美洲（包括北美和南美洲）；美国
bottle|瓶子；一瓶的容量 v. 控制；把…装入瓶中
literary|文学的；书面的；精通文学的
bicycle|自行车 v. 骑脚踏车
wallet|钱包，皮夹
superb|极好的；华丽的；宏伟的 n. (Superb)人名；(罗)苏佩尔布
pool|联营；撞球；水塘；共同资金 v. 联营，合伙经营
fragrant|芳香的；愉快的
mercy|仁慈，宽容；怜悯；幸运；善行
preview|预览；试映；事先查看 v. 预览；预演；事先查看
hatch|孵化；舱口 v. 孵；策划
school|学校；学院；学派；鱼群 v. 教育
promote|促进；提升；推销；发扬
crew|队，组；全体人员，全体船员 v. 一起工作
preparation|预备；准备
tomorrow|明天；未来 adv. 明天；未来地（等于to-morrow）
taste|味道；品味；审美 v. 尝；体验
abortion|流产，堕胎，小产；流产的胎儿；（计划等）失败，夭折
sparrow|麻雀；矮小的人
bond|债券；结合；约定；粘合剂；纽带 v. 结合，团结在一起
face|脸；表面；面子；面容；外观；威信 v. 向；朝
wound|创伤，伤口 v. 使受伤
mustard|芥末；芥菜；深黄色；强烈的兴趣
ruler|尺；统治者；[测] 划线板，划线的人
umbrella|雨伞；保护伞；庇护；伞形结构
pub|酒馆；客栈
playground|运动场，操场；游乐场
arbitrary|[数] 任意的；武断的；专制的
turning|转向；旋转；回转；转弯处 v. 旋转（turn的ing形式）
account|账户；解释；账目，账单；理由；描述 v. 解释；导致；报账
quite|很；相当；完全
wake|醒来；唤醒；警觉 n. 尾迹；守夜；守丧
workmate|同事；工友
album|相簿；唱片集；集邮簿；签名纪念册
dangerous|危险的
replace|取代，代替；替换，更换；归还，偿还；把…放回原处
eyesight|视力；目力
tremble|发抖；战栗；焦虑；摇晃 n. 颤抖；战栗；摇晃
cage|笼，兽笼；牢房，监狱 v. 把…关进笼子；把…囚禁起来
either|两者之中任一的；两者之中每一的 prep. 任何一个 conj. 也（用于否定句或否定词组后）；根本 pron. 任一，两方，随便哪一个；两者中的一个或另一个
lucky|幸运的；侥幸的
order|命令；顺序；规则；[贸易] 定单 v. 命令；整理；定购
south|南方，南边；南部 adv. 在南方，向南方 adj. 南的，南方的
mobile|可移动的；机动的；易变的；非固定的 n. 运动物体
door|门；家，户；门口；通道
list|[计] 列表；清单；目录 v. 列于表上
videophone|电视电话
empty|空的；无意义的；无知的；徒劳的 v. 使失去；使…成为空的 n. 空车；空的东西
armchair|扶手椅，单人沙发 adj. 不切实际的
self|自己，自我；本质；私心 adj. 同一的 vt. 使自花授精；使近亲繁殖 vi. 自花授精
nature|自然；性质；本性；种类
transparent|透明的；显然的；坦率的；易懂的
submit|使服从；主张；呈递
agriculture|农业；农耕；农业生产；农艺，农学
exactly|恰好地；正是；精确地；正确地
undo|取消；解开；破坏；扰乱
cheerful|快乐的；愉快的；高兴的
remind|提醒；使想起
disaster|灾难，灾祸；不幸
daily|日常的；每日的 n. 日报；朝来夜去的女佣 adv. 日常地；每日；天天
cheers|感谢；谢谢；再见
season|时期；季节；赛季 v. 给…调味；使适应
dislike|不喜欢，厌恶 n. 嫌恶，反感，不喜爱
software|软件
steel|钢铁；钢制品；坚固 v. 钢化；使冷酷 adj. 钢制的；钢铁业的；坚强的
industry|产业；工业；勤勉
there|在那里；在那边；在那点上 int. 你瞧 n. 那个地方
botany|植物学；地区植物总称
unfortunately|不幸地
gain|增加；利润；收获 v. 获得；增加；赚到
together|一起；同时；相互；连续地；总共 adj. 新潮的；情绪稳定的，做事有效率的
visit|访问；参观；逗留 v. 访问；参观；视察
gather|收集；收割；使…聚集；使…皱起 n. 聚集；衣褶；收获量
over|结束；越过；从头到尾 prep. 越过；在…之上；遍于…之上 adj. 结束的；上面的 vt. 越过 n. (Over)人名；(俄、西、土)奥韦尔
madam|夫人；女士；鸨母
recreation|娱乐；消遣；休养
dive|潜水；跳水；俯冲；急剧下降 n. 潜水；跳水；俯冲；扑
wing|翼；翅膀；飞翔；派别；侧厅，耳房，厢房 v. 使飞；飞过；空运；增加…速度；装以翼
lemon|柠檬色的 n. 柠檬
record|记录，记载；标明；将录音 n. 档案，履历；唱片；最高纪录 adj. 创纪录的
beach|海滩；湖滨 v. 将…拖上岸
chairwoman|女主席；女议长
basement|地下室；地窖
schedule|安排，计划；编制目录；将……列入计划表 n. 时间表；计划表；一览表
wood|木材；木制品；树林 vi. 收集木材 vt. 植林于；给…添加木柴
deaf|聋的
architect|建筑师
walnut|胡桃；胡桃木 adj. 胡桃科植物的
irish|爱尔兰的；爱尔兰人的 n. 爱尔兰人；爱尔兰语；爱尔兰
manner|方式；习惯；种类；规矩；风俗
twin|使成对 n. 双胞胎中一人 adj. 双胞胎的
powerful|强大的；强有力的 adv. 很；非常
frequent|频繁的；时常发生的；惯常的 v. 常到，常去；时常出入于
dam|控制；筑坝 n. [水利] 水坝；障碍
free|免费的；自由的，不受约束的；[化学] 游离的 v. 使自由，解放；释放 adv. 自由地；免费 n. (Free)人名；(英)弗里
ninety|九十 adj. 九十的；九十岁的 num. 九十
fright|惊吓；惊骇 v. 使惊恐
snake|蛇；阴险的人 v. 迂回前进
version|版本；译文；倒转术
disabled|残废的，有缺陷的 v. 使…失去能力（disable的过去分词）
march|（坚定地向某地）前进；行军，进军；游行示威；进展，进行 n. 行进，前进；行军；游行示威；进行曲
truth|真理；事实；诚实；实质
heel|脚后跟；踵 v. 倾侧
furnished|家具，有家具的 v. 供应；装备（furnish的过去分词）
nest|巢，窝；安乐窝；温床 v. 筑巢；嵌套
conclude|推断；决定，作结论；结束
basin|水池；流域；盆地；盆
pear|[园艺] 梨树；梨子
awkward|尴尬的；笨拙的；棘手的；不合适的
stopwatch|码表；跑表 vt. 用秒表测定时间
shame|羞耻，羞愧；憾事，带来耻辱的人 v. 使丢脸，使羞愧
quiz|考查；恶作剧；课堂测验 v. 挖苦；张望；对…进行测验
forty|四十 adj. 四十的；四十个的
clumsy|笨拙的
ground|地面；土地；范围；战场;根据 v. 使接触地面；打基础；使搁浅 adj. 土地的；地面上的；磨碎的；磨过的
show|显示；说明；演出；展出 n. 显示；表演；炫耀
rebuild|重建；改造，重新组装；复原
politician|政治家，政客
north|北，北方 adj. 北方的；朝北的 adv. 在北方，向北方
rat|鼠；卑鄙小人，叛徒 v. 捕鼠；背叛，告密
nor|也不；也不是 adv. 也不；也没有 n. (Nor)人名；(中)挪(广东话·威妥玛)；(马来、俄)诺尔；(柬)诺
captain|队长，首领；船长；上尉；海军上校 v. 指挥；率领
cautious|谨慎的；十分小心的
guest|客人，宾客；顾客 v. 款待，招待 adj. 客人的；特邀的，客座的
hair|头发；毛发；些微 vt. 除去…的毛发 vi. 生长毛发；形成毛状纤维 adj. 毛发的；护理毛发的；用毛发制成的
dozen|十二个，一打 adj. 一打的
certificate|发给证明书；以证书形式授权给…；用证书批准 n. 证书；执照，文凭
love|恋爱；亲爱的；酷爱；喜爱的事物；爱情，爱意；疼爱；热爱；爱人，所爱之物 v. 爱，热爱；爱戴；赞美，称赞；喜爱；喜好；喜欢；爱慕
container|集装箱；容器
flour|面粉；粉状物质 v. 撒粉于；把…磨成粉
total|全部的；完全的；整个的 v. 总数达 n. 总数，合计
purple|紫色的；帝王的；华而不实的 n. 紫色；紫袍 v. 变成紫色
withdraw|撤退；收回；撤消；拉开
insist|坚持，强调
joke|玩笑，笑话；笑柄 v. 开…的玩笑
autonomous|自治的；自主的；自发的
all|全部的 adv. 全然地；越发 n. 全部 pron. 全部
score|分数；二十；配乐；刻痕 v. 获得；评价；划线，刻划；把…记下
protect|保护，防卫；警戒
handwriting|笔迹；书法；书写；手稿 v. 亲手写（handwrite的ing形式）
sing|唱歌；歌颂；鸣叫；呼号 n. 演唱；鸣声；呼啸声
deliver|交付；发表；递送；释放；给予（打击）；给…接生 n. 投球
meaning|意义；含义；意图 adj. 意味深长的 v. 意味；意思是（mean的ing形式）
balcony|阳台；包厢；戏院楼厅
hibernation|冬眠；过冬；避寒
vase|瓶；花瓶
resemble|类似，像
cab|驾驶室；出租汽车；出租马车 v. 乘出租马车（或汽车）
decision|决定，决心；决议
composition|作文，作曲，作品；[材] 构成；合成物；成分
tent|帐篷；住处；帷幕 v. 用帐篷遮盖；使在帐篷里住宿
rewind|重绕；倒带器 v. 倒回；重绕
conductor|导体；售票员；领导者；管理人
edition|版本
female|女性的；雌性的；柔弱的，柔和的 n. 女人；[动] 雌性动物
determination|决心；果断；测定
equal|平等的；相等的；胜任的 v. 等于；比得上 n. 对手；匹敌；同辈；相等的事物
little|小的；很少的；短暂的；小巧可爱的 adv. 完全不 n. 少许；没有多少；短时间
hibernate|过冬；（动物）冬眠；（人等）避寒
pepper|胡椒；辣椒；胡椒粉 v. 加胡椒粉于；使布满
glove|手套 vt. 给…戴手套
diary|日志，日记；日记簿
citizen|公民；市民；老百姓
destroy|破坏；消灭；毁坏
altogether|完全地；总共；总而言之 n. 整个；裸体
contribution|贡献；捐献；投稿
decoration|装饰，装潢；装饰品；奖章
view|观察；视野；意见；风景 v. 观察；考虑；查看
darkness|黑暗；模糊；无知；阴郁
bar|条，棒；酒吧；障碍；法庭 v. 禁止；阻拦 prep. 除……外
dessert|餐后甜点；甜点心
wag|摇摆；摇动；饶舌 n. 摇摆；爱说笑打趣的人
vinegar|醋
realize|实现；认识到；了解；将某物卖得，把(证券等)变成现钱；变卖
exhibition|展览，显示；展览会；展览品
broadcast|播送，播放；（无线电或电视）广播；播撒（种子） n. 广播；播音；广播节目 adj. 广播的
parrot|鹦鹉；学舌者，应声虫；机械模仿别人的人 v. 机械地模仿
debt|债务；借款；罪过
birdcage|鸟笼；鸟笼状物；信号灯；宿舍
scare|惊吓；把…吓跑 n. 恐慌；惊吓；惊恐 adj. （美）骇人的
where|在哪里 pron. 哪里 conj. 在…的地方 n. 地点
ambulance|[车辆][医] 救护车；战时流动医院
easy|容易的；舒适的 adv. 不费力地，从容地 vi. 停止划桨 vt. 发出停划命令
housework|家务事
concrete|混凝土的；实在的，具体的；有形的 v. 凝结 n. 具体物；凝结物
sound|听（诊）；测量，测…深；使发声；试探；宣告 n. 声音，语音；噪音；海峡；吵闹；听力范围；[医] 探条 adj. 健全的，健康的；合理的；可靠的；有效彻底的 adv. 彻底地，充分地
scientist|科学家
construct|建造，构造；创立 n. 构想，概念
get|使得；获得；受到；变成 n. 生殖；幼兽
tall|高的；长的；过分的；夸大的 adv. 夸大地 n. (Tall)人名；(马里、阿拉伯)塔勒；(芬、罗、瑞典)塔尔；(英)托尔；(土)塔勒
diploma|毕业证书，学位证书；公文，文书；奖状 vt. 发给…毕业文凭
beside|在旁边；与…相比；和…无关
photographer|摄影师；照相师
anchor|锚；抛锚停泊；靠山；新闻节目主播 v. 抛锚；使固定；主持节目 adj. 末棒的；最后一棒的
a|字母A；第一流的；学业成绩达最高标准的评价符号 abbr. [物]安（ampere）
social|社会的，社交的；群居的 n. 联谊会；联欢会
easily|容易地；无疑地
chess|国际象棋，西洋棋
strange|奇怪的；陌生的；外行的 adv. 奇怪地；陌生地，冷淡地 n. (Strange)人名；(英)斯特兰奇；(瑞典、塞)斯特朗格
sick|厌恶的；病态的；不舒服；渴望的；恶心的 ；生病的 n. 病人 v. 使狗去咬；呕吐；追击
russian|俄国的；俄语的 n. 俄语；俄国人
inland|内地；内陆 adj. 内陆的；内地的；国内的 adv. 在内地；向内地；向内陆；在内陆
academy|学院；研究院；学会；专科院校
invent|发明；创造；虚构
wealth|财富；大量；富有
chick|小鸡；小鸟；少妇 adj. 胆小的；懦弱的
companion|同伴；朋友；指南；手册 v. 陪伴
mouth|口，嘴；河口 v. 做作地说，装腔作势地说；喃喃地说出
find|查找，找到；发现；认为；感到；获得 n. 发现
town|城镇，市镇；市内商业区
trousers|裤子，长裤
performer|演出者；执行者；演奏者
petrol|（英）汽油
solid|固体的；可靠的；立体的；结实的；一致的 n. 固体；立方体
uncomfortable|不舒服的；不安的
expense|损失，代价；消费；开支 vt. 向…收取费用 vi. 被花掉
bowling|滚木球戏；保龄球戏 v. 打保龄球（bowl的现在分词）
metre|米；公尺；韵律
passage|一段（文章）；走廊；通路
nearly|差不多，几乎；密切地
institute|开始（调查）；制定；创立；提起（诉讼） n. 学会，协会；学院
draw|画；拉；吸引 n. 平局；抽签
as|因为；随着；虽然；依照；当…时 prep. 如同；当作；以…的身份 adv. 同样地；和…一样的
meal|一餐，一顿饭；膳食 vi. 进餐
sneeze|打喷嚏 n. 喷嚏
bit|[计] 比特（二进位制信息单位）；少量；马嚼子；辅币；老一套；一点，一块 vt. 控制 adj. 很小的；微不足道的 adv. 有点儿；相当
but|但是；而是；然而 adv. 仅仅，只 prep. 除…以外 n. (But)人名；(俄、罗)布特；(越)笔
monitor|监视器；监听器；监控器；显示屏；班长 v. 监控
thrill|激动；震颤；紧张 v. 使…颤动；使…紧张；使…感到兴奋或激动
advice|建议；忠告；劝告；通知
whale|猛揍；使惨败 n. 鲸；巨大的东西
vacant|空虚的；空的；空缺的；空闲的；茫然的 n. (Vacant)人名；(法)瓦康
underground|在地下；秘密地 adj. 地下的；秘密的；先锋派的 n. 地下；地铁；地道；地下组织；秘密活动；先锋派团体
rocket|飞驰，飞快地移动；迅速增加 n. 火箭
trial|试验；审讯；努力；磨炼 adj. 试验的；审讯的
shanghai|上海（中国东部港市）
root|根；根源；词根；祖先 v. 生根；根除
nationwide|全国范围的；全国性的 adv. 在全国
hotel|旅馆，饭店；客栈 vt. 使…在饭店下榻 vi. 进行旅馆式办公
specialist|专家；专门医师 adj. 专家的；专业的
any|任何的；所有的；丝毫 pron. 任何；任何一个；若干 adv. 稍微；少许 n. (Any)人名；(法、罗)阿尼
thirty|三十年代 num. 三十 adj. 三十个的
attractive|吸引人的；有魅力的；引人注目的
phenomenon|现象；奇迹；杰出的人才
counter|柜台；对立面；计数器；（某些棋盘游戏的）筹码 v. 反击，还击；反向移动，对着干；反驳，回答 adj. 相反的 adv. 反方向地；背道而驰地
scarf|围巾；嵌接，嵌接处；头巾领巾 v. 披嵌接；用围巾围
tail|尾巴；踪迹；辫子；燕尾服 v. 尾随；装上尾巴 adj. 从后面而来的；尾部的
swear|发誓；咒骂 n. 宣誓；诅咒
high|高的；高级的；崇高的；高音调的 n. 高水平；天空；由麻醉品引起的快感；高压地带 adv. 高；奢侈地
adjustment|调整，调节；调节器
rely|依靠；信赖
deserve|应受，应得
mine|矿，矿藏；矿山，矿井；地雷，水雷 v. 开采，采掘；在…布雷 pron. 我的
aids|获得性免疫缺乏综合征；爱滋病（Acquired Immune Deficiency Syndrome）
deal|处理；给予；分配；发牌 n. 交易；（美）政策；待遇；份量
apron|围裙；[航] 停机坪；舞台口 vt. 着围裙于；围绕
data|数据（datum的复数）；资料
acquaintance|熟人；相识；了解；知道
great|伟大的，重大的；极好的，好的；主要的 n. 大师；大人物；伟人们
bandage|绷带 v. 用绷带包扎
oral|口头的，口述的 n. 口试
throw|投；抛；掷 n. 投掷；冒险
loss|减少；亏损；失败；遗失
regulation|管理；规则；校准 adj. 规定的；平常的
boil|煮沸，沸腾；激动，激昂 n. 沸腾，煮沸；疖子
greece|希腊（欧洲南部国家）
chart|图表；海图；图纸；排行榜 v. 绘制…的图表；在海图上标出；详细计划；记录；记述；跟踪（进展或发展
shape|形状；模型；身材；具体化 v. 形成；塑造，使成形；使符合
milk|牛奶；乳状物 v. 榨取；挤…的奶
group|组；团体 adj. 群的；团体的 v. 聚合
prevent|预防，防止；阻止
associate|交往；结交 n. 同事，伙伴；关联的事物 adj. 副的；联合的
plug|插头；塞子；栓 v. 塞住；用插头将与电源接通
detective|侦探的 n. 侦探
alcohol|酒精，乙醇
offshore|离岸的；[海洋] 近海的；吹向海面的 adv. 向海面，向海
cigar|雪茄
jacket|羽绒滑雪衫；西装短外套；短上衣，夹克；土豆皮；书籍的护封；文件套，公文夹 v. 给…穿夹克；给…装护套；给…包上护封；〈口〉打
red|红色，红颜料；赤字 adj. 红色的；红肿的，充血的
christian|基督徒，信徒 adj. 基督教的；信基督教的
theoretical|理论的；理论上的；假设的；推理的
also|也；而且；同样 conj. 并且；另外 n. (Also)人名；(罗)阿尔索
necessary|必要的；必需的；必然的 n. 必需品
gold|金，黄金；金色；金币 adj. 金的，金制的；金色的
sympathy|同情；慰问；赞同
tomato|番茄，西红柿
create|创造，创作；造成
anyhow|总之；无论如何；不管怎样
declare|宣布，声明；断言，宣称
recommend|推荐，介绍；劝告；使受欢迎；托付
london|伦敦
addicted|沉溺于某种（尤其是不良的）嗜好的；入了迷的，上了瘾的 v. 使…上瘾（addict的过去分词）
focus|焦点；中心；清晰；焦距 v. 使集中；使聚焦
forget|忘记；忽略 n. (Forget)人名；(法)福尔热
sailing|航行，航海；启航；航海术 adj. 航行的 v. 航行，起航（sail的现在分词形式）
serious|严肃的，严重的；认真的；庄重的；危急的
dad|爸爸；爹爹
scold|责骂；叱责 n. 责骂；爱责骂的人
vacation|假期；（房屋）搬出 v. 休假，度假
immediate|立即的；直接的；最接近的
timetable|时间表；时刻表；课程表
recycle|使再循环；使…重新利用 n. 再生；再循环；重复利用
fall|落下；变成；来临；减弱 n. 下降；秋天；瀑布 adj. 秋天的
join|参加；结合；连接 n. 结合；连接；接合点
pink|粉红色；化身，典范；石竹花；头面人物 v. 扎，刺，戳；使…变粉红色；使…面红耳赤 adj. 粉红的；比较激进的；石竹科的；脸色发红的
joy|欢乐，快乐；乐趣；高兴 v. 欣喜，欢喜
muddy|泥泞的；模糊的；混乱的 v. 使污浊；使沾上泥；把…弄糊涂
rest|使休息，使轻松；把…寄托于 n. 休息，静止；休息时间；剩余部分；支架
exit|出口，通道；退场 v. 退出；离去
headline|大标题；内容提要；栏外标题；头版头条新闻 v. 给…加标题；使成为注意中心；大力宣传
flu|流感
network|网络；广播网；网状物
vehicle|[车辆] 车辆；工具；交通工具；运载工具；传播媒介；媒介物
task|分派任务 n. 工作，作业；任务
unbearable|难以忍受的；承受不住的
rapid|迅速的，急促的；飞快的；险峻的 n. 急流；高速交通工具，高速交通网
concentrate|集中；浓缩；全神贯注；聚集 n. 浓缩，精选；浓缩液
tiresome|烦人的，无聊的；令人讨厌的
market|市场；行情；股票市场；市面；集市；销路；商店 v. 在市场上出售
burst|爆发，突发；爆炸 n. 爆发，突发；爆炸
volcano|火山
brush|刷子；画笔；毛笔；争吵；与某人有效冲突；灌木丛地带；矮树丛；狐狸尾巴 v. 刷；画；
motherland|祖国；母国
ear|耳朵；穗；听觉；倾听 vi. （美俚）听见；抽穗
circuit|[电子] 电路，回路；巡回；一圈；环道 v. 环行
in|按照（表示方式）；从事于；在…之内 adv. 进入；当选；（服装等）时髦；在屋里 adj. 在里面的；时髦的 n. 执政者；门路；知情者
pin|大头针，别针，针；栓；琐碎物 v. 钉住；压住；将……用针别住
belong|属于，应归入；居住；适宜；应被放置
brotherhood|兄弟关系；手足情谊；四海之内皆兄弟的信念
music|音乐，乐曲
brother|兄弟；同事；战友 int. 我的老兄！
pleasant|令人愉快的，舒适的；讨人喜欢的，和蔼可亲的 n. (Pleasant)人名；(英)普莱曾特
worried|担心的
chicken|鸡肉；小鸡；胆小鬼，懦夫 adj. 鸡肉的；胆怯的；幼小的
argue|争论，辩论；提出理由 n. (Argue)人名；(英、法)阿格
dress|给…穿衣 n. 连衣裙；女装
convince|说服；使确信，使信服
reporter|记者
sky|天空；顶点 v. 把…投向空中；把…挂得过高
voluntary|自愿的；志愿的；自发的；故意的 n. 志愿者；自愿行动
drug|药；毒品；麻醉药；滞销货 v. 使服麻醉药；使服毒品；掺麻醉药于
enquiry|[计] 询问，[贸易] 询盘
dip|浸，泡，蘸；舀取；把伸入 n. 下沉，下降；倾斜；浸渍，蘸湿
cuisine|烹饪，烹调法
daughter|女儿；[遗][农学] 子代 adj. 女儿的；子代的
product|产品；结果；[数] 乘积；作品
mixture|混合；混合物；混合剂
name|名称，名字；姓名；名誉 v. 命名，任命；指定；称呼；提名；叫出 adj. 姓名的；据以取名的
litre|[计量] 公升（米制容量单位）
typhoon|[气象] 台风
helpful|有帮助的；有益的
predict|预报，预言；预知
uncertain|无常的；含糊的；靠不住的；迟疑不决的
noodle|面条；笨蛋
foolish|愚蠢的；傻的
turn|转动，使旋转；转弯；翻过来；兑换 n. 转弯；变化；(损害或有益于别人的)行为，举动，举止
horrible|可怕的；极讨厌的
cell|细胞；电池；蜂房的巢室；单人小室 vi. 住在牢房或小室中
dismiss|解散；解雇；开除；让离开；不予理会、不予考虑
boring|无聊的；令人厌烦的 n. 钻孔 v. 钻孔；使厌烦；挖空（bore的ing形式）
obvious|明显的；显著的；平淡无奇的
rainy|下雨的；多雨的 n. (Rainy)人名；(英)雷尼
violence|暴力；侵犯；激烈；歪曲
antique|古老的，年代久远的；过时的，古董的；古风的，古式的 n. 古董，古玩；古风，古希腊和古罗马艺术风格 v. 觅购古玩
experiment|尝试；进行实验 n. 实验，试验；尝试
field|领域；牧场；旷野；战场；运动场 v. 担任场外队员 adj. 扫描场；田赛的；野生的
handbag|手提包
include|包含，包括
ripe|熟的，成熟的；时机成熟的 vt. 搜查；调查 vi. 进行搜查 n. (Ripe)人名；(意、瑞典)里佩
peasant|农民；乡下人
athletics|竞技；体育运动；田径运动
discover|发现；发觉
leak|泄漏；漏洞，裂缝 v. 使渗漏，泄露
rainfall|降雨；降雨量
tool|工具，用具；器械，机床；手段 v. 使用工具；用机床装备工厂
bite|咬；刺痛 n. 咬；一口；咬伤；刺痛 abbr. 机内测试设备（Built-In Test Equipment）
praise|赞扬；称赞；荣耀；崇拜 v. 赞美，歌颂；表扬
activity|活动；行动；活跃
carry|拿，扛；携带；支持；搬运 n. 运载；[计] 进位；射程
take|拿，取；采取；接受（礼物等）；买，花费；耗费（时间等） n. 捕获量；看法；利益，盈益；（入场券的）售得金额
dimension|方面;[数] 维；尺寸；次元；容积 vt标出尺寸 adj. 规格的
format|格式；版式；开本 v. 使格式化；规定…的格式
start|开始；启动 n. 开始；起点
week|周，星期
reject|拒绝；排斥；抵制；丢弃 n. 被弃之物或人；次品
artificial|人造的；仿造的；虚伪的；非原产地的；武断的
welcome|受欢迎的 n. 欢迎 v. 欢迎 int. 欢迎
earth|地球；地表，陆地；土地，土壤；尘事，俗事；兽穴 v. 把（电线）[电] 接地；盖（土）；追赶入洞穴
avenue|大街；林荫大道；[比喻](达到某物的)途径，手段，方法，渠道
strawberry|草莓；草莓色
translate|翻译；转化；解释；转变为；调动
sea|海；海洋；许多；大量
drill|训练；钻孔机；钻子；播种机 v. 钻孔；训练
page|页；记录；大事件，时期；男侍者 v. 给…标页码
stamp|邮票；印记；标志；跺脚 v. 铭记；标出；盖章于…；贴邮票于…；用脚踩踏
along|一起；向前；来到 prep. 沿着；顺着
style|风格；时尚；类型；字体 v. 设计；称呼；使合潮流
garden|花园；菜园 v. 栽培花木
oppose|反对；对抗，抗争
nationality|国籍，国家；民族；部落
consultant|顾问；咨询者；会诊医生
load|负载，负荷；工作量；装载量 v. [力] 加载；装载；装货
behavious|行为
nylon|尼龙，[纺] 聚酰胺纤维；尼龙袜
statue|雕像，塑像 vt. 以雕像装饰
witness|证人；目击者；证据 v. 目击；证明；为…作证
difficult|困难的；不随和的；执拗的
moral|道德的；精神上的；品性端正的 n. 道德；寓意
evidence|证据，证明；迹象；明显 v. 证明
pour|倾泻；流出；骤雨 v. 灌，注；倒；倾泻；倾吐
map|映射；计划；绘制地图；确定基因在染色体中的位置 n. 地图；示意图；染色体图
blouse|宽松的上衣；女装衬衫 vt. 使…宽松下垂 vi. 宽松下垂
lab|实验室，研究室
hall|过道，门厅，走廊；会堂；食堂；学生宿舍；大厅，前厅；娱乐中心，会所
compromise|妥协；危害 n. 妥协，和解；折衷
motivation|动机；积极性；推动
unfit|不适宜的；不合格的；不健康的 v. 使不合格；使不相宜；使不胜任
lonely|寂寞的；偏僻的 n. 孤独者
gifted|有天赋的；有才华的 v. 给予（gift的过去分词）
considerate|体贴的；体谅的；考虑周到的
plot|情节；图；阴谋 v. 密谋；绘图；划分；标绘
carrot|胡萝卜
nothing|没什么；毫不 n. 无；零；不关紧要之事 adv. 毫不；决不 pron. 无事；无物 int. 什么也没有
brochure|手册，小册子
weight|重量，重力；负担；砝码；重要性 v. 加重量于，使变重
hope|希望；期望；信心 v. 希望；期望
lorry|（英）卡车；[车辆] 货车；运料车
noisily|吵闹地，喧闹地
cloud|云；阴云；云状物；一大群；黑斑 v. 使混乱；以云遮敝；使忧郁；玷污
topic|主题（等于theme）；题目；一般规则；总论
hug|拥抱；紧抱；抱有，坚持 n. 拥抱；紧抱；固执
size|大小；尺寸 adj. 一定尺寸的 v. 依大小排列
ladder|阶梯；途径；梯状物 v. 成名；发迹
folk|民族；人们；亲属（复数） adj. 民间的
energetic|精力充沛的；积极的；有力的
mop|擦干；用拖把拖洗 n. 拖把；蓬松的头发；鬼脸
assumption|假定；设想；担任；采取
flesh|肉；肉体 v. 喂肉给…；使发胖
marathon|马拉松赛跑；耐力的考验 adj. 马拉松式的；有耐力的 vi. 参加马拉松赛跑
remove|移动，迁移；开除；调动 n. 移动；距离；搬家
sun|太阳 v. 使晒
expect|期望；指望；认为；预料
ward|病房；保卫；监视 v. 避开；保卫；守护
comfortable|舒适的，舒服的 n. 盖被
yesterday|昨天；往昔 adv. 昨天
feeling|感觉，触觉；感情，情绪；同情 adj. 有感觉的；有同情心的；富于感情的 v. 感觉；认为（feel的现在分词）；触摸
spaghetti|意大利式细面条
his|他的 n. (His)人名；(法)伊斯
media|媒体；媒质（medium的复数）；血管中层；浊塞音；中脉
director|主任，主管；导演；人事助理
produce|生产；引起；创作；生育，繁殖 n. 农产品，产品
waist|腰，腰部
porter|门房；服务员；行李搬运工；守门人
nut|螺母，螺帽；坚果；难对付的人，难解的问题 v. 采坚果
westwards|向西 adj. 向西的
offence|犯罪；违反；过错；攻击
vocabulary|词汇；词表；词汇量
aim|目的在于；引导；把…对准 n. 目的；目标；对准
receptionist|接待员；传达员
greengrocer|蔬菜水果商；菜贩
box|箱，盒子；包厢；一拳 v. 拳击
jaw|颌；下巴；狭窄入口；唠叨 v. 教训；唠叨
cinema|电影；电影院；电影业，电影制作术
weed|除草；铲除 n. 杂草，野草；菸草
merry|愉快的；微醉的；嬉戏作乐的 n. 甜樱桃
accident|事故；意外；[法] 意外事件；机遇
suitable|适当的；相配的
pilot|飞行员；领航员 adj. 试点的 v. 驾驶；领航；试用
friendship|友谊；友爱；友善
floor|地板，地面；楼层；基底；议员席 v. 铺地板；打倒，击倒；（被困难）难倒
magic|巫术；魔法；戏法 adj. 不可思议的；有魔力的；魔术的
unfold|打开；呈现
october|[天] 十月
musician|音乐家
lounge|休息室；闲逛；躺椅；（英）酒吧间 v. 闲逛；懒洋洋地躺卧；闲混
strait|狭窄的；苦恼的 n. 海峡；困境
suite|（一套）家具；套房；组曲；（一批）随员，随从
lively|活泼的；生动的；真实的；生气勃勃的 n. (Lively)人名；(英)莱夫利
cigarette|香烟；纸烟
hometown|家乡；故乡
shortly|立刻；简短地；唐突地
arrow|箭，箭头；箭状物；箭头记号 vt. 以箭头指示；箭一般地飞向
may|五月
attach|使依附；贴上；系上；使依恋
fortnight|两星期
expose|揭露，揭发；使曝光；显示
pollute|污染；玷污；败坏
thank|感谢 n. 感谢 int. 谢谢
ski|滑雪橇 v. 滑雪 adj. 滑雪（用）的
sunshine|阳光；愉快；晴天；快活
project|设计；计划；表达；投射 n. 工程；计划；事业
southwest|西南方 adj. 西南的 adv. 往西南；来自西南
illegal|[法] 非法的；违法的；违反规则的 n. 非法移民，非法劳工
statistics|统计；统计学；[统计] 统计资料
level|水平；标准；水平面 adj. 水平的；平坦的；同高的 v. 瞄准；拉平；变得平坦
cosy|舒适的；惬意的 n. 保温罩
tight|紧的；密封的；绷紧的；麻烦的；严厉的；没空的；吝啬的 adv. 紧紧地；彻底地 n. (Tight)人名；(英)泰特
shadow|阴影；影子；幽灵；庇护；隐蔽处 v. 遮蔽；使朦胧；尾随；预示 adj. 影子内阁的
continent|大陆，洲，陆地 adj. 自制的，克制的
bacterium|[微] 细菌；杆菌属
roundabout|迂回的，绕道的；圆滚滚的 n. 迂回路线；环状交叉路口
connection|连接；关系；人脉；连接件
bottom|底部；末端；臀部；尽头 adj. 底部的 v. 装底；测量深浅；查明真相
printer|[计] 打印机；印刷工；印花工
aboard|在飞机上；[船] 在船上；在火车上 prep. 在…上
writing|书写；作品；著作；[法] 笔迹 v. 书写（write的ing形式）
bleed|使出血；榨取
spy|侦察；发现；暗中监视 n. 间谍；密探
soldier|军人；[昆] 兵蚁；懒汉；一片烤面包 v. 当兵；磨洋工；坚持干；假称害病
temperature|温度；体温；气温；发烧
both|两个的；两者的 adv. 并；又；两者皆 pron. 双方都；两者都 conj. 既…且… n. (Both)人名；(德、罗、捷、南非、匈)博特
fresh|新鲜的；清新的；淡水的；无经验的 n. 开始；新生；泛滥 adv. 刚刚，才；最新地
kingdom|王国；界；领域
boating|划船 adj. 划船的 v. 划船（boat的ing形式）
tendency|倾向，趋势；癖好
concert|音乐会；一致；和谐 v. 使协调；协同安排 adj. 音乐会用的；在音乐会上演出的
consume|消耗，消费；使…著迷；挥霍
six|六，六个 n. 六，六个
refresh|更新；使……恢复；使……清新；消除……的疲劳
broad|宽的，辽阔的；显著的；大概的 n. 宽阔部分 adv. 宽阔地
camp|露营；扎营 n. 露营
gale|[气象] 大风，狂风；（突发的）一阵
borrow|借；借用；从其他语言中引入 n. (Borrow)人名；(英)博罗
demand|要求；需要；查询 n. [经] 需求；要求；需要
knock|敲；打；敲击 n. 敲；敲打；爆震声
sour|酸的；发酵的；刺耳的；酸臭的；讨厌的 v. 发酵；变酸；厌烦 n. 酸味；苦事
grandpa|爷爷；外公
zip|拉链；活力，精力；尖啸声，撕裂声；一种程序压缩的档案文件格式 v. 拉开或拉上；以尖啸声行进
rank|排；等级；军衔；队列 adj. 讨厌的；恶臭的；繁茂的 v. 排列；把…分等
butcher|屠杀 n. 屠夫
ready|准备好；现成的；迅速的；情愿的；快要…的 n. 现款；预备好的状态 adv. 迅速地；预先 v. 使准备好
pig|猪；猪肉 v. 生小猪；像猪一样过活
trap|诱捕；使…受限制；使…陷入困境 n. 陷阱；圈套；[建] 存水湾
cancer|癌症；恶性肿瘤
vice|恶习；缺点；[机] 老虎钳；卖淫 prep. 代替 vt. 钳住 adj. 副的；代替的
harm|伤害；损害 v. 伤害；危害；损害
rare|稀有的；稀薄的；半熟的 adv. 非常；极其 vi. 用后腿站起；渴望
brewery|啤酒厂
finish|完成；结束；用完 n. 结束；完美；回味（葡萄酒）
cock|公鸡；龙头；雄鸟；头目 v. 使竖起；使耸立；使朝上
fairly|相当地；公平地；简直 n. (Fairly)人名；(英)费尔利
grandparents|祖父母（grandparent的复数）；外祖父母
instant|立即的；紧急的；紧迫的 n. 瞬间；立即；片刻
see|看见；理解；领会 n. (See)人名；(英)西伊；(柬)塞；(德)泽
back|后面；背部；靠背；足球等的后卫；书报等的末尾 v. 支持；后退；背书；下赌注 adv. 以前；向后地；来回地；上溯；回来；回原处 adj. 后面的；过去的；拖欠的
area|区域，地区；面积；范围
sacrifice|牺牲；祭品；供奉 v. 牺牲；献祭；亏本出售
africa|非洲
collision|碰撞；冲突；（意见，看法）的抵触；（政党等的）倾轧
homeland|祖国；故乡
technical|工艺的，科技的；技术上的；专门的
ink|签署；涂墨水于 n. 墨水，墨汁；油墨
faith|信仰；信念；信任；忠实
never|从未；决不
quarrel|吵架；争论；挑剔 n. 吵架；反目；怨言；争吵的原因；方头凿
undivided|专心的；专一的；未分开的；完整的 v. 未分开（undivide的过去式和过去分词）
separation|分离，分开；间隔，距离；[法] 分居；缺口
indicate|表明；指出；预示；象征
will|意志；决心；情感；遗嘱；意图；心愿 v. 决心要；遗赠；用意志力使 aux. 将；愿意；必须
express|表达；快递 adj. 明确的；迅速的；专门的 n. 快车，快递，专使；捷运公司
fast|快速的，迅速的；紧的，稳固的 adv. 迅速地；紧紧地；彻底地 v. 禁食，斋戒 n. 斋戒；绝食
open|公开的；敞开的；空旷的；坦率的；营业着的 v. 开始；展现 n. 公开；空旷；户外
pocket|口袋；钱；容器 v. 隐藏；忍受；将…放入衣袋 adj. 小型的，袖珍的；金钱上的
soul|灵魂；心灵；精神；鬼魂 adj. 美国黑人文化的
branch|分支；出现分歧 n. 树枝，分枝；分部；支流
tip|给小费；翻倒；倾覆 n. 小费；尖端；小建议，小窍门；轻拍
mutton|羊肉
boom|使兴旺；发隆隆声 n. 繁荣；吊杆；隆隆声
magazine|杂志；弹药库；胶卷盒
hospital|医院
sock|短袜；一击 v. 重击；给……穿袜 adv. 正着地；不偏不倚地 adj. 非常成功的
physics|物理学；物理现象
taxi|乘出租车；滑行 n. 出租汽车
facial|面部的，表面的；脸的，面部用的 n. 美容，美颜；脸部按摩
famous|著名的；极好的，非常令人满意的
china|中国 adj. 中国的；中国制造的
exam|考试；测验
passenger|旅客；乘客；过路人；碍手碍脚的人
seagull|海鸥
when|考虑到；既然；当…时；在…时；如果 adv. 什么时候，何时；（用于时间的表达方式之后）在那时；其时；当时 pron. 那时；什么时侯 n. 时间，时候；日期；场合
trick|诡计；恶作剧；窍门；花招；骗局；欺诈 v. 欺骗；哄骗；装饰；打扮 adj. 特技的；欺诈的；有决窍的
fix|使固定；修理；安装；准备 n. 困境；方位；贿赂
onto|在…之上；对…了解；映射到…上 adj. 映射的；自身的；映成的
commit|犯罪，做错事；把交托给；指派…作战；使…承担义务
oval|椭圆的；卵形的 n. 椭圆形；卵形
building|建筑；建筑物 v. 建筑；建立；增加（build的ing形式）
evolution|演变；进化论；进展
disgusting|令人厌恶的
unmarried|[法] 未婚的；单身的；独身的 v. 离婚（unmarry的过去分词）
chair|椅子；讲座；（会议的）主席位；大学教授的职位 v. 担任（会议的）主席；使…入座；使就任要职
reasonable|合理的，公道的；通情达理的
hide|隐藏；隐瞒；鞭打 n. 躲藏；兽皮；躲藏处
bye|再见 n. 轮空；次要的东西 adj. 次要的
sharpen|削尖；磨快；使敏捷；加重
fantastic|奇异的；空想的；异想天开的；古怪的；极好的，极出色的；不可思议的；不切实际的 n. 古怪的人
eraser|橡皮；擦除器；[计] 清除器
chemical|化学制品，化学药品 adj. 化学的
ministry|（政府的）部门
sponsor|赞助者；主办者；保证人 v. 赞助；发起
nose|鼻子；嗅觉；突出的部分；探问 v. 嗅；用鼻子触
reserve|储备，储存；自然保护区；预备队；缄默；[金融] 储备金 v. 储备；保留；预约
during|在…的时候，在…的期间 n. (During)人名；(法)迪兰；(瑞典、利比)杜林
corn|（美）玉米；（英）谷物；[皮肤] 鸡眼 v. 腌；使成颗粒
unfair|不公平的，不公正的
educate|教育；培养；训练
arrange|安排；排列；整理
rise|上升；增强；起立；高耸 n. 上升；高地；增加；出现
month|月，一个月的时间
competence|能力，胜任；权限；作证能力；足以过舒适生活的收入
noon|中午；正午；全盛期
glasshouse|温室；暖房
water|水；海水；雨水；海域，大片的水 v. 使湿；供以水；给…浇水
key|（打字机等的）键；关键；钥匙 v. 键入；锁上；调节…的音调；提供线索 adj. 关键的
lung|肺；呼吸器
sixty|六十；六十个
january|一月
fried|油炸的，油煎的；喝醉了的 v. 油炸（fry的过去分词）
kilogram|公斤；千克
smooth|顺利的；光滑的；平稳的 v. 使光滑；消除（障碍等）；使优雅；缓和 n. 平滑部分；一块平地 adv. 光滑地；平稳地；流畅地
reviewer|评论者，评论家
inside|里面；内部；内情；内脏 adj. 里面的；内部的；秘密的 adv. 在里面 prep. 少于；在…之内
second|秒；第二名；瞬间；二等品 v. 支持 adj. 第二的；次要的；附加的 num. 第二 adv. 第二；其次；居第二位
master|控制；精通；征服 n. 硕士；主人；大师；教师 adj. 主人的；主要的；熟练的
healthy|健康的，健全的；有益于健康的
file|文件；档案；文件夹；锉刀 v. 提出；锉；琢磨；把…归档
seventh|第七；七分之一 adj. 第七的；七分之一的 adv. 居第七位地
college|大学；学院；学会
liberty|自由；许可；冒失
blow|吹；打击；殴打 v. 风吹；喘气
questionnaire|问卷；调查表
christmas|圣诞节；圣诞节期间
father|父亲，爸爸；神父；祖先；前辈 v. 发明，创立；当…的父亲
everyone|每个人；人人 n. 每个人
mild|温和的；轻微的；淡味的；文雅的；不含有害物质的的 n. （英国的一种）淡味麦芽啤酒
could|能够 v. 能（can的过去式）
automatic|自动的；无意识的；必然的 n. 自动机械；自动手枪
article|文章；物品；条款；[语] 冠词 v. 订约将…收为学徒或见习生；使…受协议条款的约束
link|[计] 链环，环节；联系，关系 v. 连接，连结；联合，结合
cd|光盘，激光唱片（Compact Disc）；呼叫设备（Calling Device）；中央地区（Central District）；商务部（Commerce Department）
about|关于；大约 adj. 在附近的；四处走动的；在起作用的 adv. 大约；周围；到处 n. 大致；粗枝大叶；不拘小节的人
local|[计] 局部；当地居民；本地新闻 adj. 当地的；局部的；地方性的；乡土的
hydrogen|[化学] 氢
backache|背痛；腰痛
temptation|引诱；诱惑物
crayon|蜡笔，有色粉笔 v. 以蜡笔作画，用颜色粉笔画
fruit|水果；产物 v. 结果实
learned|博学的；有学问的；学术上的 n. (Learned)人名；(英)勒尼德
rather|宁可，宁愿；相当 int. 当然啦（回答问题时用） n. (Rather)人名；(英)拉瑟
job|工作；职业 v. 承包；代客买卖
mathematics|数学；数学运算
occupation|职业；占有；消遣；占有期
consequence|结果；重要性；推论
increase|增加，增长；提高 v. 增加，增大；繁殖
forest|植树于，使成为森林 n. 森林
relative|相对的；有关系的；成比例的 n. 亲戚；相关物；[语] 关系词；亲缘植物
pupil|学生；[解剖] 瞳孔；未成年人
visa|签证 v. 签发签证
restriction|限制；约束；束缚
fridge|电冰箱
behind|落后于；支持；晚于 adv. 在后地；在原处 n. 屁股
swing|摇摆；摆动；秋千；音律；涨落 v. 摇摆；转向；悬挂；大摇大摆地行走 adj. 旋转的；悬挂的；强节奏爵士音乐的
approach|方法；途径；接近 v. 接近；着手处理
correct|改正；告诫 adj. 正确的；恰当的；端正的
at|在（表示存在或出现的地点、场所、位置、空间）；以（某种价格、速度等）；向；达；因为；朝；忙于 n. 阿特（老挝货币基本单位att）；[化]砹（极不稳定放射性元素） abbr. 密封的（airtight）；气温（air temperature）
pill|药丸；弹丸，子弹；口服避孕药 v. 把…制成丸剂；使服用药丸；抢劫，掠夺（古语）
underline|强调；在…下面划线；预告 n. 下划线；下期节目预告
team|队；组 v. 使合作
scholarship|奖学金；学识，学问
committee|委员会
stick|刺，戳；伸出；粘贴 n. 棍；手杖；呆头呆脑的人
cowboy|牛仔；牧童；莽撞的人
expectation|期待；预期；指望
unconditional|无条件的；绝对的；无限制的
drier|干燥机；干燥剂；吹风机
end|结束；目标；尽头；末端；死亡 v. 结束，终止；终结
permission|允许，许可
use|使用；用途；发挥 v. 利用；耗费
hearing|听力；审讯，听讯 v. 听见（hear的ing形式）
iron|熨斗；烙铁；坚强 v. 熨；用铁铸成 adj. 铁的；残酷的；刚强的
reward|[劳经] 报酬；报答；酬谢 v. [劳经] 奖励；奖赏
signal|信号；暗号；导火线 v. 标志；用信号通知；表示 adj. 显著的；作为信号的
oneself|自己；亲自
argument|论证；论据；争吵；内容提要
character|性格，品质；特性；角色；[计] 字符 v. 印，刻；使具有特征
northwards|向北
hat|帽子 v. 给……戴上帽子
improve|改善，增进；提高…的价值
fail|失败，不及格；破产；缺乏；衰退 n. 不及格
scholar|学者；奖学金获得者
require|需要；要求；命令
mention|提到，谈到；提及，论及；说起 n. 提及，说起
eight|八；八个；第八 adj. 八的 n. 八字形
attention|注意力；关心；立正！（口令）
decline|下降；衰退；斜面 v. 下降；衰落；谢绝
skillfully|巧妙地；精巧地
cat|猫，猫科动物
last|末尾，最后；上个；鞋楦（做鞋的模型） adj. 最后的；最近的，最新的；仅剩的；最不可能…的 v. 持续；维持，够用；持久 adv. 最后地；上次，最近；最后一点
yourself|你自己
like|喜欢；想；愿意 prep. 像；如同 adj. 同样的；相似的 n. 爱好；同样的人或物 adv. 可能 conj. 好像
west|西；西方；西部 adj. 西方的；朝西的 adv. 在西方；向西方；自西方
surgeon|外科医生
flow|流动，涌流；川流不息；飘扬 n. 流动；流量；涨潮，泛滥
congratulate|祝贺；恭喜；庆贺
whole|完整的；纯粹的 n. 整体；全部
miss|女士，小姐，年轻未婚女子
brief|简短的，简洁的；短暂的，草率的 n. 摘要，简报；概要，诉书 v. 简报，摘要；作…的提要
animal|动物
question|问题，疑问；询问；疑问句 v. 询问；怀疑；审问
inn|客栈；旅馆 vi. 住旅馆
polish|磨光，擦亮；擦亮剂；优雅，精良 v. 擦亮，变光滑 adj. 波兰的
principle|原理，原则；主义，道义；本质，本义；根源，源泉
satisfaction|满意，满足；赔偿；乐事；赎罪
clean|清洁的，干净的；清白的 v. 使干净 adv. 完全地 n. 打扫
reputation|名声，名誉；声望
belly|腹部；胃；食欲 v. 涨满；鼓起
suck|吸吮；吸取 n. 吮吸
toilet|厕所，盥洗室；梳妆，打扮 vi. 梳妆，打扮 vt. 给…梳妆打扮
bacon|咸肉；腌肉；熏猪肉
poison|污染；使中毒，放毒于；败坏；阻碍 n. 毒药，毒物；酒；有毒害的事物；[助剂] 抑制剂 adj. 有毒的
motorbike|摩托车
sink|下沉；消沉；渗透 n. 水槽；洗涤槽；污水坑
tongue|舌头；语言 v. 舔；斥责；用舌吹
violin|小提琴；小提琴手
delicate|微妙的；精美的，雅致的；柔和的；易碎的；纤弱的；清淡可口的
embassy|大使馆；大使馆全体人员
error|误差；错误；过失
disadvantage|缺点；不利条件；损失
green|绿色的；青春的 n. 绿色；青春 v. 使…变绿色
seek|寻求；寻找；探索；搜索
maybe|也许；可能；大概 n. 可能性；不确定性
graph|图表；曲线图 v. 用曲线图表示
recipe|食谱；[临床] 处方；秘诀；烹饪法
laser|激光
entrance|入口；进入 v. 使出神，使入迷
rent|租金 v. 出租；租用；租借
match|使比赛；使相配；敌得过，比得上；相配；与…竞争 n. 比赛，竞赛；匹配；对手；火柴
very|恰好是，正是；甚至；十足的；特有的 adv. 非常，很；完全 n. (Very)人名；(英)维里
raw|生的；未加工的；阴冷的；刺痛的；擦掉皮的；无经验的；（在艺术等方面）不成熟的 n. 擦伤处 vt. 擦伤
absurd|荒谬的；可笑的 n. 荒诞；荒诞作品
possibility|可能性；可能发生的事物
garage|车库；汽车修理厂；飞机库 v. 把……送入车库；把（汽车）开进车库
oxygen|[化学] 氧气，[化学] 氧
goat|山羊；替罪羊（美俚）；色鬼（美俚）
radiation|辐射；发光；放射物
fog|雾；烟雾，尘雾；迷惑 v. 使模糊；使困惑；以雾笼罩
host|[计] 主机；主人；主持人；许多 v. 主持；当主人招待
amazing|令人惊异的 v. 使吃惊（amaze的ing形式）
outdoors|在户外 n. 户外 adj. 户外的（等于outdoor）
progress|进步，发展；前进 v. 前进，进步；进行
authentic|真正的，真实的；可信的
omelette|煎蛋卷
headmistress|女校长
trip|绊倒；远足；犯错误；轻快地走 n. 旅行；绊倒；差错
transport|运输；运输机；狂喜；流放犯 v. 运输；流放；使狂喜
erupt|爆发；喷出；发疹；长牙
forgetful|健忘的；不注意的；疏忽的；使遗忘的
sir|先生；（用于姓名前）爵士；阁下；（中小学生对男教师的称呼）先生；老师
friend|朋友；助手；赞助者
holiday|假日；节日；休息日 v. 外出度假
drink|喝，饮；吸收；举杯庆贺 n. 酒，饮料；喝酒
commercial|商业的；营利的；靠广告收入的 n. 商业广告
whenever|每当；无论何时 adv. 不论何时；随便什么时候
emperor|皇帝，君主
bingo|宾戈游戏
operator|经营者；操作员；话务员；行家
apology|道歉；谢罪；辩护；勉强的替代物
pure|纯的；纯粹的；纯洁的；清白的；纯理论的 n. (Pure)人名；(俄)普雷
devotion|献身，奉献；忠诚；热爱
grade|年级；等级；成绩；级别；阶段 v. 评分；把…分等级
now|现在；如今；立刻 adj. 现在的 n. 现在；目前 conj. 由于；既然
wounded|受伤的 n. 受伤者，伤员 v. 使受伤（wound的过去分词）
hen|母鸡；女人；雌禽
opposite|相反的；对面的；对立的 n. 对立面；反义词 prep. 在…的对面 adv. 在对面
profit|利润；利益 v. 获利；有益
courage|勇气；胆量
outstanding|杰出的；显著的；未解决的；未偿付的 n. 未偿贷款
shelter|庇护；避难所；遮盖物 v. 保护；使掩蔽
look|看；期待；注意；面向；看上去像 n. 看；样子；面容
coast|滑行；沿岸航行 n. 海岸；滑坡
ignore|驳回诉讼；忽视；不理睬
different|不同的；个别的，与众不同的
real|实际的；真实的；实在的 adv. 真正地；确实地 n. 现实；实数
typical|典型的；特有的；象征性的
handy|便利的；手边的，就近的；容易取得的；敏捷的 n. (Handy)人名；(英)汉迪
broken|破碎的；坏掉的 v. 折断；打碎；损坏（break的过去分词）
aloud|大声地；出声地
appear|出现；显得；似乎；出庭；登场
barbershop|理发店 adj. 有男声合唱之和声的
student|学生；学者
yummy|好吃的；美味的；愉快的 n. 美味的东西；令人喜爱的东西
midnight|午夜，半夜12点钟 adj. 半夜的；漆黑的
addition|添加；[数] 加法；增加物
weatherman|气象员；天气预报员
permit|许可；允许 n. 许可证，执照
hand|手，手艺；帮助；指针；插手 v. 传递，交给；支持；搀扶
obtain|获得；流行
prize|奖品；奖赏；战利品 v. 珍视；捕获；估价 adj. 获奖的
content|内容，目录；满足；容量 adj. 满意的 v. 使满足
firmly|坚定地，坚决地；坚固地，稳固地
colour|把…涂颜色，粉饰；歪曲；使脸红 n. 颜色；风格；气色，面色；外貌
tired|疲倦的；厌倦的，厌烦的 v. 疲倦；对…腻烦（tire的过去分词形式）
vague|模糊的；含糊的；不明确的；暧昧的 n. (Vague)人名；(法)瓦格；(英)韦格
classic|经典的；古典的，传统的；最优秀的 n. 名著；经典著作；大艺术家
concern|涉及，关系到；使担心 n. 关系；关心；关心的事；忧虑
talent|才能；天才；天资
several|几个的；各自的 pron. 几个；数个
simply|简单地；仅仅；简直；朴素地；坦白地
india|印度（南亚国家）
acre|土地，地产；英亩
potato|[作物] 土豆，[作物] 马铃薯
adopt|采取；接受；收养；正式通过
knee|膝盖，膝 v. 用膝盖碰
newspaper|报纸
uniform|统一的；一致的；相同的；均衡的；始终如一的 n. 制服 v. 使穿制服；使成一样
support|支持，支撑，支援；扶持，帮助；赡养，供养 n. 支持，维持；支援，供养；支持者，支撑物
conservation|保存，保持；保护
fundamental|基本的，根本的 n. 基本原理；基本原则
wayside|路旁 adj. 路旁的
request|请求；需要 v. 要求，请求
coke|焦炭；可卡因；可口可乐（Coca-Cola） v. 焦化
between|在…之间 adv. 在中间
opener|[五金] 开启工具；开启的人
credit|信用，信誉；[金融] 贷款；学分；信任；声望 v. 相信，信任；把…归给，归功于；赞颂
absorb|吸收；吸引；承受；理解；使…全神贯注
multiply|乘；使增加；使繁殖；使相乘 adv. 多样地；复合地 adj. 多层的；多样的
chocolate|巧克力，巧克力糖；巧克力色 adj. 巧克力色的；巧克力口味的
ball|球；舞会 v. 成团块
cheque|支票
russia|俄罗斯
tibetan|西藏的；藏族的 n. 藏语；西藏人
temple|庙宇；寺院；神殿；太阳穴
fire|火；火灾；炮火；炉火；热情；激情；磨难 v. 点燃；解雇；开除；使发光；烧制；激动；放枪
excite|激起；刺激…，使…兴奋
parcel|包裹，小包 v. 打包；捆扎
ability|能力，能耐；才能
leave|离开；留下；遗忘；委托 n. 许可，同意；休假
handle|[建] 把手；柄；手感；口实 v. 处理；操作；运用；买卖；触摸
flashlight|手电筒；闪光灯
keyboard|键盘 v. 键入；用键盘式排字机排字
candidate|候选人，候补者；应试者
photograph|为…拍照；使深深印入 n. 照片，相片
glass|玻璃；玻璃制品；镜子 v. 反映；给某物加玻璃
tradition|惯例，传统；传说
these|这些 adj. 这些的
unlike|不同的，不相似的 prep. 和…不同，不像
seldom|很少，不常
please|使喜欢；使高兴，使满意 int. 请（礼貌用语）
overcome|克服；胜过
except|不计；把…除外 prep. 除…之外 conj. 除了；要不是
advocate|提倡，主张，拥护 n. 提倡者；支持者；律师
mountainous|多山的；巨大的；山一般的
four|四；四个 adj. 四的；四个的 n. (Four)人名；(西)福尔；(法)富尔
meet|满足；遇见；对付 n. 集会 adj. 合适的；适宜的
dynasty|王朝，朝代
reach|达到；延伸；伸出手；传开 n. 范围；延伸；河段；横风行驶
ordinary|普通的；平凡的；平常的 n. 普通；平常的人（或事）
challenging|挑战的；引起挑战性兴趣的 v. 要求；质疑；反对；向…挑战；盘问（challenge的ing形式）
speed|超速，加速；加速，迅速前行；兴隆 n. 速度，速率；迅速，快速；昌盛，繁荣
once|一次；曾经 conj. 一旦 n. 一次，一回
type|类型，品种；模范；样式 v. 打字；测定（血等）类型
sweet|甜的；悦耳的；芳香的；亲切的 n. 糖果；乐趣；芳香；宝贝
goodness|天哪 n. 善良，优秀 ；精华，养分
irrigation|灌溉；[临床] 冲洗；冲洗法
tourist|旅行者，观光客 adj. 旅游的 vt. 在旅行参观 vi. 旅游；观光 adv. 坐旅游车厢；坐经济舱
buffet|自助餐；小卖部；打击；猛烈冲击 v. 与…搏斗；连续猛击 adj. 自助的；自助餐的
share|分享，分担；分配 n. 份额；股份
intelligence|智力；情报工作；情报机关；理解力；才智，智慧；天分
aware|意识到的；知道的；有…方面知识的；懂世故的 n. (Aware)人名；(阿拉伯、索)阿瓦雷
adolescent|青春期的；未成熟的 n. 青少年
scan|扫描；浏览；细看；详细调查；标出格律 n. 扫描；浏览；审视；细看
anecdote|轶事；奇闻；秘史
former|从前的，前者的；前任的 n. 模型，样板；起形成作用的人
fetch|取来；接来；到达；吸引 n. 取得；诡计
toothbrush|牙刷
egyptian|埃及的；埃及人的 n. 埃及人；古代埃及语
reform|改革，改良；改正 v. 改革，革新；重新组成 adj. 改革的；改革教会的
bench|长凳；工作台；替补队员 v. 给…以席位；为…设置条凳
best|最好的人，最好的事物；最佳状态 adj. 最好的 adv. 最好地 v. 打败，胜过
vest|背心；汗衫 v. 授予；使穿衣
weakness|弱点；软弱；嗜好
luck|运气；幸运；带来好运的东西 v. 靠运气，走运；凑巧碰上
friday|星期五
helicopter|[航] 直升飞机 vi. [航] 乘直升飞机 vt. 由直升机运送
dare|挑战；挑动 v. 敢冒；不惧
confidential|机密的；表示信任的；获信任的
slight|轻微的，少量的；脆弱的；细长的；不重要的 v. 轻视，忽略；怠慢 n. 怠慢；轻蔑
wait|等候；推迟；延缓 n. 等待；等候
journey|旅行；行程 v. 旅行
lazy|懒惰的；懒洋洋的；怠惰的；慢吞吞的 n. (Lazy)人名；(德)拉齐
understanding|谅解，理解；理解力；协议 adj. 了解的；聪明的；有理解力的 v. 理解；明白（understand的ing形式）
loudspeaker|喇叭，扬声器；扩音器
chimney|烟囱
sweep|扫除；猛拉；掸去 n. 打扫，扫除；范围；全胜
endless|无止境的；连续的；环状的；漫无目的的
instrument|仪器；工具；乐器；手段；器械
zoom|急速上升；嗡嗡声；[摄] 变焦摄影 v. 急速上升；摄像机移动
prison|监狱；监禁；拘留所 vt. 监禁，关押
pianist|钢琴家；钢琴演奏者
ballpoint|圆珠笔
rooster|公鸡；狂妄自负的人
capsule|胶囊；[植] 蒴果；太空舱；小容器 adj. 压缩的；概要的 v. 压缩；简述
rag|破布；碎屑 v. 戏弄；责骂
game|游戏；比赛 adj. 勇敢的 v. 赌博
port|港口，口岸；（计算机的）端口；左舷；舱门 v. 转向左舷
leaf|叶子；（书籍等的）一张；扇页 v. 生叶；翻书页
waiter|服务员，侍者
flower|花；精华；开花植物 v. 成熟，发育；开花；繁荣；旺盛
dusty|落满灰尘的
attraction|吸引，吸引力；引力；吸引人的事物
sister|姐妹；（称志同道合者）姐妹；修女；护士 adj. 姐妹般的；同类型的
vegetable|蔬菜；植物；植物人 adj. 蔬菜的；植物的
beehive|蜂窝；蜂箱
fool|欺骗；开玩笑；戏弄 n. 傻瓜；愚人；受骗者 adj. 傻的
firework|烟火；激烈情绪
dusk|黄昏，薄暮；幽暗，昏暗 adj. 微暗的 v. 使变微暗
somewhere|在某处；到某处 n. 某个地方
low|低的，浅的；卑贱的；粗俗的；消沉的 adv. 低声地；谦卑地，低下地 n. 低；低价；低点；牛叫声 v. 牛叫
motto|座右铭，格言；箴言
union|联盟，协会；工会；联合
most|最；非常，极其；最多；几乎 adj. 大部分的，多数的；最多的 n. 大部分，大多数
skyscraper|摩天楼，超高层大楼；特别高的东西
chemist|化学家；化学工作者；药剂师；炼金术士
apple|苹果，苹果树，苹果似的东西；[美俚]炸弹，手榴弹，（棒球的）球；[美俚]人，家伙。
convey|传达；运输；让与
bathrobe|浴衣；睡衣
enjoy|欣赏，享受；喜爱；使过得快活
platform|平台；月台，站台；坛；讲台
dentist|牙科医生
turkey|火鸡；笨蛋；失败之作
eastwards|向东方地 adj. 向东方的
confirm|确认；确定；证实；批准；使巩固
scratch|擦伤；抓痕；刮擦声；乱写 adj. 打草稿用的；凑合的；碰巧的 v. 抓；刮；挖出；乱涂
spray|喷雾；喷雾器；水沫 v. 喷射
happiness|幸福
sand|沙；沙地；沙洲；沙滩；沙子 v. 撒沙于；以沙掩盖；用砂纸等擦平或磨光某物；使撒沙似地布满；给…掺沙子
hook|挂钩，吊钩 v. 钩住；引上钩
jungle|丛林，密林；危险地带 adj. 丛林的；蛮荒的
cleaner|[化工] 清洁剂；清洁工；干洗店；干洗商；洗洁器
develop|开发；进步；使成长；使显影
standard|标准；水准；旗；度量衡标准 adj. 标准的；合规格的；公认为优秀的
patent|授予专利；取得…的专利权 adj. 专利的；新奇的；显然的 n. 专利权；执照；专利品
modest|谦虚的，谦逊的；适度的；端庄的；羞怯的 n. (Modest)人名；(罗)莫代斯特；(德)莫德斯特；(俄)莫杰斯特
cookie|饼干；小甜点
german|德国的；德语的，德国人的 n. 德语；德国人
popular|流行的，通俗的；受欢迎的；大众的；普及的
lead|领导；铅；导线；榜样 v. 领导；致使；引导；指挥 adj. 带头的；最重要的
labour|劳动力，人工；分娩 v. 劳动；分娩；费力地前进
textbook|教科书，课本
feather|羽毛 v. 用羽毛装饰
forehead|额，前额
barrier|障碍物，屏障；界线 vt. 把…关入栅栏
provide|提供；规定；准备；装备
throughout|自始至终，到处；全部 prep. 贯穿，遍及
optimistic|乐观的；乐观主义的
careful|仔细的，小心的
rose|玫瑰；粉红色；蔷薇（花）；粉红色的葡萄酒 adj. 玫瑰花的；玫瑰色的；粉红色的；带有玫瑰香味的 vt. 使成玫瑰色，使（面颊）发红；使有玫瑰香味 vi. 起义( rise的过去式)；升起；（数量）增加；休会
slide|滑动；幻灯片；滑梯；雪崩 v. 滑动；滑落；不知不觉陷入
sadness|悲哀
cooker|炊具；烹饪用水果；窜改者
runner|跑步者；走私者；推销员；送信人
hunt|打猎；搜索 n. 狩猎；搜寻
courtyard|庭院，院子；天井
seven|七个，七 n. 七个，七 adj. 七的；七个的
ballet|芭蕾舞剧；芭蕾舞乐曲
angry|生气的；愤怒的；狂暴的；（伤口等）发炎的
jewel|宝石；珠宝 v. 镶以宝石；饰以珠宝
due|到期的；预期的；应付的；应得的 n. 应付款；应得之物 adv. 正（置于方位词前）
abroad|在国外；到海外 adj. 往国外的 n. 海外；异国
sob|啜泣，呜咽；（风等）发出呜咽声 n. 啜泣，呜咽
sunny|阳光充足的，和煦的；快活的；性情开朗的
black|黑色的；黑人的；邪恶的 n. 黑色；黑人；黑颜料 v. 使变黑；把鞋油等涂在…上；把（眼眶）打成青肿
contain|包含；控制；容纳；牵制（敌军）
comfort|安慰；舒适；安慰者 v. 安慰；使（痛苦等）缓和
sightseeing|观光；游览 adj. 观光的；游览的 v. 观光（sightsee的ing形式）；游览
session|会议；（法庭的）开庭；（议会等的）开会；学期；讲习会
toy|玩具；小装饰品；不值钱的东西 v. 玩弄；调情；随随便便地对待 adj. 作为玩具的；玩物似的
comprehension|理解；包含
unsuccessful|不成功的；失败的
annual|年度的；每年的 n. 年刊，年鉴；一年生植物
sunburnt|晒黑的；有晒斑的；日炙的 v. 晒黑（sunburn的过去式和过去分词）
method|方法；条理；类函数 adj. 使用体验派表演方法的
treasure|财富，财产；财宝；珍品 v. 珍爱；珍藏
moment|片刻，瞬间，时刻；重要，契机
applaud|赞同；称赞；向…喝彩
grammar|语法；语法书
ever|永远；曾经；究竟 n. (Ever)人名；(英)埃弗；(俄)叶韦尔；(西、法)埃韦尔
fish|捕鱼，钓鱼；用钩捞取 n. 鱼，鱼类
bright|明亮的，鲜明的；聪明的；愉快的 adv. 明亮地；光明地；欢快地 n. 车头灯光
flame|火焰；热情；光辉 v. 焚烧；泛红
light|光；光线；灯；打火机；领悟；浅色；天窗 adj. 轻的；浅色的；明亮的；轻松的；容易的；清淡的 v. 点着；变亮；着火 adv. 轻地；清楚地；轻便地
nobody|无人，没有人；没有任何人 n. 无名小卒；小人物
object|目标；物体；客体；宾语 v. 提出…作为反对的理由
workday|工作日 adj. 日常的，工作日的；平凡的
film|电影；薄膜；胶卷；轻烟 v. 在…上覆以薄膜；把…拍成电影
immediately|立即，立刻；直接地 conj. 一…就
inspire|激发；鼓舞；启示；产生；使生灵感
scream|尖叫；呼啸；发出尖锐刺耳的声音；令人触目惊心 n. 尖叫声；尖锐刺耳的声音；极其滑稽可笑的人
table|桌子；表格；平地层 v. 制表；搁置；嵌合 adj. 桌子的
anxious|焦虑的；担忧的；渴望的；急切的
agenda|议程；日常工作事项；日程表
policy|政策，方针；保险单
panda|熊猫；猫熊
clay|[土壤] 粘土；泥土；肉体；似黏土的东西 vt. 用黏土处理
assistance|援助，帮助；辅助设备
expensive|昂贵的；花钱的
outing|远足；短途旅游；体育比赛 adj. 远足适用的 v. 出来；暴露（out的ing形式）
buddhist|佛教徒 adj. 佛教的
pm|（拉）下午（Post Meridiem，等于afternoon）；调相（Phase Modulation）
algebra|代数学
tidy|整齐的；相当大的 v. 整理；收拾；弄整齐 n. 椅子的背罩
manager|经理；管理人员
funny|有趣的，好笑的，滑稽的；（口）稀奇的，古怪的，奇异的；有病的，不舒服的；狡猾的，欺骗（性）的，可疑的，不光明 n. 滑稽人物；笑话，有趣的故事；滑稽连环漫画栏；（英）（比赛用）单人双桨小艇
suffer|遭受；忍受；经历 n. (Suffer)人名；(意)苏费尔
curriculum|课程
razor|剃，用剃刀刮 n. 剃刀
universe|宇宙；世界；领域
suitcase|[轻] 手提箱；衣箱
police|警察，警方；治安 v. 监督；管辖；维持治安；为…配备警察 adj. 警察的；有关警察的
ceiling|天花板；上限
theory|理论；原理；学说；推测
direct|直接的；直系的；亲身的；恰好的 v. 管理；指挥；导演；指向 adv. 直接地；正好；按直系关系
some|一些；某个；大约；相当多的 pron. 一些；若干；其中的一部分；（数量不确切时用）有些人 adv. 非常；相当；<美>稍微
tasty|美味的；高雅的；有趣的 n. 可口的东西；引人入胜的东西
contemporary|同时代的人；同时期的东西 adj. 当代的；同时代的；属于同一时期的
punctual|准时的，守时的；精确的
must|必须，一定；可以，应当；很可能 n. 绝对必要的事物；未发酵葡萄汁
attract|吸引；引起
wisdom|智慧，才智；明智；学识；至理名言
shorts|短裤
negotiate|谈判，商议；转让；越过
feast|享受；款待，宴请 n. 筵席，宴会；节日
practical|实际的；实用性的
private|私人的；私有的；私下的 n. 列兵；二等兵
technique|技巧，技术；手法
bun|小圆面包
rabbit|兔子，野兔 v. 让…见鬼去吧
yet|还；但是；已经 conj. 但是；然而 n. (Yet)人名；(东南亚国家华语)一
germany|德国
referee|裁判员；调解人；介绍人 v. 仲裁；担任裁判
policeman|警察，警员；[分化] 淀帚（橡皮头玻璃搅棒）
normal|正常的；正规的，标准的 n. 正常；标准；常态
two|两个 adj. 两个的 num. 二
comma|逗号；停顿
couple|对；夫妇；数个 v. 结合；成婚
ours|我们的 n. (Ours)人名；(法)乌尔斯
cook|烹调，煮 n. 厨师，厨子
slim|苗条的；修长的；微小的；差的 v. 使…体重减轻；使…苗条 n. (Slim)人名；(阿拉伯)萨利姆；(英、西)斯利姆
memorize|记住，背熟；记忆
copy|复制；复印；抄袭 n. 副本；一册；摹仿
thin|薄的；瘦的；稀薄的；微弱的 v. 使瘦；使淡；使稀疏 adv. 稀疏地；微弱地 n. 细小部分
september|九月
burn|燃烧；烧毁，灼伤；激起…的愤怒 n. 灼伤，烧伤；烙印
alongside|在旁边 prep. 在……旁边
educator|教育家；教育工作者；教师
sheet|薄片，纸张；薄板；床单 v. 覆盖；盖上被单；使成大片 adj. 片状的
baggage|行李；[交] 辎重（军队的）
wrestle|摔跤；搏斗；斗争 v. 摔跤；斗争；斟酌
scores|考试成绩；比分（score的复数） v. 得分（score的第三人称单数形式）；刻划
otherwise|否则；另外；在其他方面 adj. 另外的；其他方面的；原本，本来 conj. 其他；如果不；然后
active|积极的；活跃的；主动的；有效的；现役的 n. 主动语态；积极分子
connect|连接；联合；关连
bucket|桶，水桶；铲斗；一桶的量 v. 倾盆而下；颠簸着行进
basketball|篮球；篮球运动
lend|贷；增添，提供；把……借给 n. (Lend)人名；(德)伦德
mushroom|蘑菇，伞菌；蘑菇形物体；暴发户 adj. 蘑菇的；蘑菇形的；迅速生长的 v. 迅速增加；采蘑菇；迅速生长
secondhand|二手的；旧的；间接获得的；做旧货生意的 adv. 间接地；间接听来；以旧货
god|神；（大写首字母时）上帝 vt. 膜拜，崇拜
souvenirs|纪念品；旅游纪念品；回忆
spin|旋转；纺纱；吐丝；晕眩 n. 旋转；疾驰
rubber|橡胶；橡皮；合成橡胶；按摩师 adj. 橡胶制成的 v. 涂橡胶于；用橡胶制造
sincerely|真诚地；由衷地，诚恳地
reception|接待；接收；招待会；感受；反应
sauce|酱油；沙司；调味汁 v. 使增加趣味；给…调味
spot|地点；斑点 v. 认出；弄脏；用灯光照射 adj. 现场的；现货买卖的 adv. 准确地；恰好
five|五，五个；五美元钞票 num. 五，五个 adj. 五的；五个的
workforce|劳动力；工人总数，职工总数
concept|观念，概念
angle|钓鱼；谋取 n. 角度，角，方面
vertical|垂直的，直立的；[解剖] 头顶的，顶点的 n. 垂直线，垂直面
insure|确保，保证；给…保险
coffee|咖啡；咖啡豆；咖啡色
gas|气体；[矿业] 瓦斯；汽油；毒气 v. 加油；毒（死）
radium|[化学] 镭（88号元素符号Ra）
drive|开车；猛击；飞跑 n. 驱动器；驾车；[心理] 内驱力，推进力；快车道
kiss|吻；（风等）轻拂 n. 吻；轻拂
attend|出席；上（大学等）；照料；招待；陪伴
equipment|设备，装备；器材
heroine|女主角；女英雄；女杰出人物
gentleman|先生；绅士；有身份的人
difficulty|困难，困境
follow|跟随；遵循；追求；密切注意，注视；注意；倾听 n. 跟随；追随
him|他（宾格） n. (Him)人名；(东南亚国家华语)欣；(柬)亨；(中)谦(广东话·威妥玛)
old|陈旧的，古老的；年老的 n. 古时
big|大的；重要的；量大的 adv. 大量地；顺利；夸大地 n. (Big)人名；(土)比格
anyway|无论如何，不管怎样；总之
fry|鱼苗；油炸食物 v. 油炸；油煎
commitment|承诺，保证；委托；承担义务；献身
stand|站立；位于；停滞 n. 站立；立场；看台；停止
australia|澳大利亚，澳洲
recover|恢复；弥补；重新获得 n. 还原至预备姿势
pint|品脱；一品脱的量；一品脱牛奶或啤酒
wolf|狼；色狼；残忍贪婪之人 v. 大吃；狼吞虎咽地吃
creature|动物，生物；人；创造物
sentence|[语][计] 句子，命题；宣判，判决 v. 判决，宣判
street|街道 adj. 街道的
flash|使闪光；反射 n. 闪光，闪现；一瞬间 adj. 闪光的，火速的
equality|平等；相等；[数] 等式
relate|叙述；使…有联系
independence|独立性，自立性；自主
willingly|欣然地；愿意地，乐意地
basic|基本的；基础的 n. 基础；要素
consist|由…组成；在于；符合
land|国土；陆地；地面 v. 使…登陆；使…陷于；将…卸下
user|用户
brain|头脑，智力；脑袋 v. 猛击…的头部
choice|选择；选择权；精选品 adj. 精选的；仔细推敲的
introduce|介绍；引进；提出；采用
ride|骑马；乘车；依靠；漂浮 n. 骑；乘坐；交通工具；可供骑行的路；（乘坐汽车等的）旅行；乘骑；（乘车或骑车的）短途旅程；供乘骑的游乐设施
circulate|传播，流传；循环；流通
person|人；身体；容貌，外表；人称
nursery|苗圃；托儿所；温床
regards|致意，问候 v. 视为，注意（regard的第三人称单数）
postman|邮递员；邮差
sceptical|怀疑的；怀疑论的；习惯怀疑的
cruel|残酷的，残忍的；使人痛苦的，让人受难的；无情的，严酷的
seem|似乎；像是；装作 n. (Seem)人名；(英)西姆
access|使用；存取；接近 n. 进入；使用权；通路
statement|声明；陈述，叙述；报表，清单
ambiguous|模糊不清的；引起歧义的
island|岛；岛屿；安全岛；岛状物 adj. 岛的 vt. 孤立；使成岛状
honey|蜂蜜；宝贝；甜蜜 adj. 甘美的；蜂蜜似的 v. 对…说甜言蜜语；加蜜使甜
wherever|无论什么地方；究竟在哪里 conj. 无论在哪里；无论什么情况下
yes|是, 是的 n. 是（表示肯定）
breathless|喘不过气来的；停止呼吸的
golf|高尔夫球；高尔夫球运动 v. 打高尔夫球
danger|危险；危险物，威胁
interest|兴趣，爱好；利息；趣味；同行 v. 使……感兴趣；引起……的关心；使……参与
flaming|燃烧的；火红的；激昂的 v. 燃烧；变亮；发光（flame的ing形式） n. (Flaming)人名；(法)弗拉曼
temporary|暂时的，临时的 n. 临时工，临时雇员
accomplish|完成；实现；达到
stupid|愚蠢的；麻木的；乏味的 n. 傻瓜，笨蛋
glue|粘合；似胶般固着于 n. 胶；各种胶合物
exercise|运动；练习；运用；操练；礼拜；典礼 v. 锻炼；练习；使用；使忙碌；使惊恐
winner|胜利者
sandwich|夹入；挤进；把做成三明治 n. 三明治；夹心面包
heap|堆；许多；累积 v. 堆；堆积
trend|趋势，倾向；走向 v. 趋向，伸向
cellar|地窖；酒窖；地下室 vt. 把…藏入地窖
visitor|访问者，参观者；视察者；候鸟
seed|种子；根据；精液；萌芽；子孙；原由 v. 播种；结实；成熟；去…籽
out|出现；在外；出局；出声地；不流行地 adj. 外面的；出局的；下台的 n. 出局 prep. 向；离去 v. 出来；暴露
breakfast|早餐；早饭 v. 吃早餐
certainly|当然；行（用于回答）；必定
them|他们；它们；她们 n. (Them)人名；(老)探
kindergarten|幼儿园；幼稚园
microwave|微波
hur|飓风（hurricane）
sofa|沙发；长椅
camel|[畜牧][脊椎] 骆驼；打捞浮筒；工作作风官僚 adj. 驼色的；暗棕色的 vi. 工作刻板平庸
engine|引擎，发动机；机车，火车头；工具
lift|举起；提升；鼓舞；空运；抄袭 n. 电梯；举起；起重机；搭车
surrounding|周围的，附近的 n. 环境，周围的事物
flexible|灵活的；柔韧的；易弯曲的
holy|圣洁的，神圣的；至善的 n. 神圣的东西
wrong|错误地；邪恶地，不正当地 n. 坏事；不公正 adj. 错误的；失常的；不适当的 v. 委屈；无理地对待；诽谤
crop|产量；农作物；庄稼；平头 v. 种植；收割；修剪；剪短
subjective|主观的；个人的；自觉的
blame|责备；归咎于 n. 责备；责任；过失
fireplace|壁炉
cheek|面颊，脸颊；臀部 v. 无礼地向…讲话，对…大胆无礼
fluency|（语言、文章）流利；（技能）娴熟
pen|钢笔；作家；围栏 v. 写；关入栏中
survival|幸存，残存；幸存者，残存物
slavery|奴役；奴隶制度；奴隶身份
explorer|探险家；勘探者；探测器；[医]探针
admission|承认；入场费；进入许可；坦白；录用
stress|压力；强调；紧张；重要性；重读 v. 强调；使紧张；加压力于；用重音读
brunch|早午餐
victory|胜利；成功；克服
safe|安全的；可靠的；平安的 n. 保险箱；冷藏室；纱橱
passport|护照，通行证；手段
pregnant|怀孕的；富有意义的
stair|楼梯，阶梯；梯级
bravery|勇敢；勇气
struggle|奋斗，努力；挣扎 n. 努力，奋斗；竞争
abundant|丰富的；充裕的；盛产
pronunciation|发音；读法
relay|转播；接替 n. [电] 继电器；接替，接替人员；驿马
unconscious|无意识的；失去知觉的；不省人事的；未发觉的
racial|种族的；人种的
silly|愚蠢的；不明事理的；没头脑的 n. 傻瓜
remote|遥远的；偏僻的；疏远的 n. 远程
shallow|浅的；肤浅的 n. [地理] 浅滩 v. 使变浅
satellite|卫星；人造卫星；随从；卫星国家
expert|熟练的；内行的；老练的 n. 专家；行家；能手 vt. 当专家；在…中当行家
bath|沐浴；浴室；浴盆 v. 洗澡
haircut|理发；发型
friction|摩擦，[力] 摩擦力
primitive|原始的，远古的；简单的，粗糙的 n. 原始人
moustache|小胡子；髭；触须
goose|鹅；鹅肉；傻瓜；雌鹅 v. 突然加大油门；嘘骂
absence|没有；缺乏；缺席；不注意
repair|修理；修复 n. 修理，修补；修补部位
admit|承认；准许进入；可容纳
valley|山谷；流域；溪谷
bomb|轰炸，投弹于 n. 炸弹
choir|唱诗班；合唱队；舞蹈队 v. 合唱
thing|事情；东西；事物；情况
toothpaste|牙膏
yours|你（们）的东西；你的责任[义务]；你的家属；来信，尊函 adj. 你（们）的（东西）；信末署名前用语
geography|地理；地形
loudly|大声地，响亮地
wealthy|富有的；充分的；丰裕的 n. 富人
hi|嗨！（表示问候或用以唤起注意） n. (Hi)人名；(柬)希
channel|引导，开导；形成河道 n. 通道；频道；海峡
pillow|枕头 v. 垫；枕于…；使…靠在
soup|汤，羹；马力 v. 加速；增加马力
analysis|分析；分解；验定
cassette|盒式磁带；暗盒；珠宝箱；片匣
laundry|洗衣店，洗衣房；要洗的衣服；洗熨；洗好的衣服
decrease|减少，减小；减少量 v. 减少，减小
insert|插入；嵌入 n. 插入物；管芯；镶块；[机械]刀片
encouragement|鼓励
youth|青年；青春；年轻；青少年时期
thousand|一千；一千个；许许多多 adj. 成千的；无数的
physical|[物] 物理的；身体的；物质的；根据自然规律的，符合自然法则的 n. 体格检查
change|改变；交换 n. 变化；找回的零钱
allowance|津贴，零用钱；允许；限额 v. 定量供应
asleep|睡着的；麻木的；长眠的 adv. 熟睡地；进入睡眠状态
swimming|游泳；目眩 adj. 游泳的；游泳用的；善于游泳的；晕眩的 v. 游泳；漂浮；旋转（swim的ing形式）
alternative|供选择的；选择性的；交替的 n. 二中择一；供替代的选择
kindness|仁慈；好意；友好的行为
accept|接受；承认；承担；承兑；容纳
noise|[环境] 噪音；响声；杂音 v. 谣传
clear|清楚的；清澈的；晴朗的；无罪的 v. 通过；清除；使干净；跳过 adv. 清晰地；完全地 n. 清除；空隙
adaptation|适应；改编；改编本，改写本
novel|新奇的；异常的 n. 小说
inventor|发明家；[专利] 发明人；创造者
merciful|仁慈的；慈悲的；宽容的
shopping|购物，买东西 v. 购物（shop的ing形式）
soccer|英式足球，足球
pan|平底锅；盘状的器皿；淘盘子，金盘，秤盘 v. 淘金；在浅锅中烹调（食物）；[非正式用语]严厉的批评
forecast|预报，预测；预示 n. 预测，预报；预想
drunk|喝酒（drink的过去分词） adj. 喝醉了的
whom|谁（who的宾格）
mind|理智，精神；意见；智力；记忆力 v. 介意；专心于；照料
sideways|向侧面地；向一旁 adj. 向侧面的；一旁的
spare|节约，吝惜；饶恕；分出，分让 adj. 多余的；瘦的；少量的 n. 剩余；备用零件
unique|独特的，稀罕的；[数] 唯一的，独一无二的 n. 独一无二的人或物
export|输出，出口；出口商品 v. 输出物资
success|成功，成就；胜利；大获成功的人或事物
mess|混乱；食堂，伙食团；困境；脏乱的东西 v. 弄乱，弄脏；毁坏；使就餐
airmail|航空邮件
innocent|无辜的；无罪的；无知的 n. 天真的人；笨蛋
care|关怀；照料；谨慎；忧虑 v. 照顾；关心；喜爱；顾虑
grand|宏伟的；豪华的；极重要的 n. 大钢琴；一千美元
triangle|三角（形）；三角关系；三角形之物；三人一组
full|完全的，完整的；满的，充满的；丰富的；完美的；丰满的；详尽的 adv. 十分，非常；完全地；整整 v. 把衣服缝得宽大 n. 全部；完整
translation|翻译；译文；转化；调任
pound|英镑；重击，重击声；兽栏；拘留所 v. 捣烂；敲打；监禁，拘留
count|计算；认为 n. 计数；计算；伯爵
or|或，或者；还是 n. (Or)人名；(中)柯(广东话·威妥玛)；(柬)奥；(土、匈、土库、阿塞、瑞典)奥尔
paddle|划桨；明轮翼 v. 拌；搅；用桨划
invitation|邀请；引诱；请帖；邀请函
test|试验；检验 v. 试验；测试
bathtub|浴缸
opinion|意见；主张
delight|高兴 v. 高兴
thirst|渴望；口渴；热望 v. 渴望；口渴
register|登记；注册；记录；挂号邮寄；把…挂号；正式提出 n. 登记；注册；记录；寄存器；登记簿
opening|开始；机会；通路；空缺的职位 adj. 开始的 v. 开放（open的ing形式）；打开；公开
puzzle|使…困惑；使…为难；苦思而得出 n. 谜；难题；迷惑
we|我们（主格）；笔者，本人（作者或演讲人使用）；朕，寡人 n. (We)人名；(缅)韦
bear|结果实，开花（正式） n. 熊
bedroom|卧室 adj. 两性关系的；城郊住宅区的
hurricane|飓风，暴风
mouthful|一口，满口
apologize|道歉；辩解；赔不是
handtruck|手推车
garbage|垃圾；废物
spelling|拼写；拼字；拼法 v. 拼写；意味着（spell的ing形式）；迷住
useful|有用的，有益的；有帮助的
astronomy|天文学
lesson|教训；课 vt. 教训；上课
harbour|藏匿；入港停泊；庇护 n. 海港（等于harbor）；避难所
herself|她自己（she的反身代词）；她亲自
quiet|安静的；安定的；不动的；温顺的 n. 安静；和平 v. 使平息；安慰
downstairs|在楼下 adj. 楼下的 n. 楼下
violent|暴力的；猛烈的
dictation|听写；口述；命令
cathedral|大教堂
respect|尊敬，尊重；方面；敬意 v. 尊敬，尊重；遵守
expression|表现，表示，表达；表情，脸色，态度，腔调，声调；式，符号；词句，语句，措辞，说法
dioxide|二氧化物
villager|乡村居民，村民
guidance|指导，引导；领导
grey|灰色的；灰白的 v. 使变成灰色；使变老 n. 灰色
refer|参考；涉及；提到；查阅
booth|货摊；公用电话亭
bookmark|书签（等于bookmarker）；标记
walkman|随身听（商标名称）
ha|哈！（表示惊异，愉快，怀疑，胜利等） abbr. 一种元素(hahnium,原子序105) n. (Ha)人名；(德)哈；(日)巴 (姓)
culture|文化，文明；修养；栽培 v. [细胞][微] 培养（等于cultivate）
burial|埋葬；葬礼；弃绝 adj. 埋葬的
bored|无聊的；无趣的；烦人的 v. 使厌烦（bore的过去式）；烦扰
possess|控制；使掌握；持有；迷住；拥有，具备
ease|减轻，缓和；使安心 n. 轻松，舒适；安逸，悠闲
gardening|园艺；园林工人的工作
whatever|不管什么样的 pron. 无论什么；诸如此类 conj. 无论什么
drawback|缺点，不利条件；退税
database|数据库，资料库
poisonous|有毒的；恶毒的；讨厌的
throat|喉咙；嗓子，嗓音；窄路 vt. 开沟于；用喉音说
wise|明智的；聪明的；博学的 v. 使知道；教导 n. (Wise)人名；(英)怀斯
importance|价值；重要；重大；傲慢
baby|婴儿，婴孩；孩子气的人 v. 纵容，娇纵；把……当婴儿般对待 adj. 婴儿的；幼小的
hunter|猎人；猎犬；搜寻者
acid|酸；<俚>迷幻药 adj. 酸的；讽刺的；刻薄的
signature|署名；签名；信号
board|董事会；木板；甲板；膳食 v. 上（飞机、车、船等）；用板盖上；给提供膳宿
november|十一月
accelerate|使……加快；使……增速
cow|奶牛，母牛；母兽 v. 威胁，恐吓
motor|发动机，马达；汽车 adj. 汽车的；机动的 v. 乘汽车
birth|出生；血统，出身；起源
wife|妻子，已婚妇女；夫人
totally|完全地
situation|情况；形势；处境；位置
winter|冬季；年岁；萧条期 v. 过冬 adj. 冬天的；越冬的
apparent|显然的；表面上的
picnic|野餐 v. 去野餐
carbon|[化学] 碳；碳棒；复写纸 adj. 碳的；碳处理的
proud|自豪的；得意的；自负的 n. (Proud)人名；(英)普劳德
italy|意大利（欧洲南部国家）
energy|[物] 能量；精力；活力；精神
lifetime|一生；寿命；终生；使用期 adj. 一生的；终身的
entry|进入；入口；条目；登记；报关手续；对土地的侵占
general|一般的，普通的；综合的；大体的 n. 一般；将军，上将；常规
bean|豆；嘴峰；毫无价值的东西 v. 击…的头部
such|这样的，如此的 n. (Such)人名；(英)萨奇；(德)祖赫
instruct|指导；通知；命令；教授
amusement|消遣，娱乐；乐趣
afterward|以后，后来
defense|防卫，防护；防御措施；防守 vt. 谋划抵御
fellow|家伙；朋友；同事；会员 adj. 同伴的，同事的；同道的 vt. 使…与另一个对等；使…与另一个匹敌
accumulate|累积；积聚
opera|歌剧；歌剧院；歌剧团
phrase|短语, 习语, 措辞, 乐句 v. 措词, 将(乐曲)分成乐句
cheap|便宜的；小气的；不值钱的 adv. 便宜地
deer|鹿
internet|因特网
course|科目；课程；过程；进程；道路；路线，航向；一道菜 v. 追赶；跑过
glare|刺眼；耀眼的光；受公众注目 v. 瞪眼表示
walk|步行，走；散步 v. 散步；走过
weep|哭泣；流泪；哀悼；滴落；渗出液体 n. 哭泣；眼泪；滴下
brilliant|灿烂的，闪耀的；杰出的；有才气的；精彩的，绝妙的
radioactive|[核] 放射性的；有辐射的
wave|波动；起伏；挥手示意；摇动；呈波形 n. 波动；波浪；高潮；挥手示意；卷曲
tomb|坟墓；死亡 vt. 埋葬
seize|抓住；夺取；理解；逮捕
design|设计；计划；构思 n. 设计；图案
small|少的，小的；微弱的；几乎没有的；不重要的；幼小的 adv. 小小地；卑鄙地 n. 小件物品；矮小的人
heat|高温；压力；热度；热烈 v. 使激动；把…加热
junk|垃圾，废物；舢板
sorrow|悲伤；懊悔；伤心事 v. 懊悔；遗憾；感到悲伤
bungalow|平房；小屋
technology|技术；工艺；术语
hardly|几乎不，简直不；刚刚
fee|费用；酬金；小费 v. 付费给……
promise|许诺，允诺；希望 v. 允诺，许诺；给人以…的指望或希望
mass|块，团；群众，民众；大量，众多；质量 adj. 群众的，民众的；大规模的，集中的 v. 聚集起来，聚集
settle|解决；定居；沉淀；下陷 n. 有背长椅
competitor|竞争者，对手
chapter|章，回；（俱乐部、协会等的）分会；人生或历史上的重要时期 vt. 把…分成章节
electricity|电力；电流；强烈的紧张情绪
sudden|突然的，意外的；快速的 n. 突然发生的事
supreme|最高的；至高的；最重要的 n. 至高；霸权
eyewitness|目击者；见证人
information|信息，资料；知识；情报；通知
queue|队列；长队；辫子 v. 排队；排队等候
candy|用糖煮；使结晶为砂糖；美化 n. 糖果（等于sweets）；冰糖（等于sugar candy，rock candy）；毒品 adj. 新潮的（服饰）；甜言蜜语的
sleep|睡，睡觉 n. 睡眠
act|扮演；装作，举动像 n. 行为，行动；法令，法案；（戏剧，歌剧的）一幕，段；装腔作势
belt|带；腰带；地带 v. 用带子系住；用皮带抽打
widespread|普遍的，广泛的；分布广的
study|学习，研究；课题；书房；学问 v. 学习；考虑；攻读；细察
advantage|优势；利益；有利条件 v. 获利
abnormal|反常的，不规则的；变态的
output|输出，输出量；产量；出产 v. 输出
headmaster|校长
sport|运动；游戏；娱乐；运动会；玩笑 v. 游戏 adj. 运动的
admirable|令人钦佩的；极好的；值得赞扬的
dash|破折号；冲撞 v. 使…破灭；猛撞；泼溅
thirteen|十三；十三岁；十三个 num. 十三 adj. 十三的；十三个的
ambition|野心，雄心；抱负，志向 v. 追求；有…野心
enter|进入；开始；参加 n. [计] 输入；回车
able|能；[经管] 有能力的；能干的 n. (Able)人名；(伊朗)阿布勒；(英)埃布尔
severe|严峻的；严厉的；剧烈的；苛刻的
sharpener|卷笔刀；[机] 磨具；研磨者
dream|梦想；做梦，梦见；想到 n. 梦想，愿望；梦 adj. 梦的；理想的；不切实际的
bookshelf|书架
analyze|对…进行分析，分解（等于analyse）
woman|妇女；女性；成年女子
extraordinary|非凡的；特别的；离奇的；临时的；特派的
outcome|结果，结局；成果
yoghurt|酸奶（等于yoghourt）；酸乳酪
make|使得；进行；布置，准备，整理；制造；认为；获得；形成；安排；引起；构成 n. 制造；构造；性情
only|只，仅仅；不料 adj. 唯一的，仅有的；最合适的 conj. 但是；不过；可是
title|冠军；标题；头衔；权利；字幕 v. 加标题于；赋予头衔；把…称为 adj. 冠军的；标题的；头衔的
card|卡片；纸牌；明信片 v. 记于卡片上
spell|拼，拼写；意味着；招致；拼成；迷住；轮值 n. 符咒；一段时间；魅力
win|赢得；在…中获胜；劝诱 n. 赢；胜利
australian|澳大利亚的，澳大利亚人的 n. 澳大利亚人
champion|冠军；拥护者；战士 v. 支持；拥护 adj. 优胜的；第一流的
clarify|澄清；阐明
comedy|喜剧；喜剧性；有趣的事情
biography|传记；档案；个人简介
clock|时钟；计时器 v. 记录；记时
employ|使用，采用；雇用；使忙于，使从事于 n. 使用；雇用
sixth|月的第六日，（与the连用的）第六个；六分之一 adj. （与 the 连用）第六的，第六个的；六分之一的
injure|伤害，损害
period|周期，期间；时期；月经；课时；（语法学）句点，句号 adj. 某一时代的
excuse|借口；理由 v. 原谅；为…申辩；给…免去
prayer|祈祷，祷告；恳求；祈祷文
fork|叉；餐叉；耙 v. 叉起；使成叉状
greet|欢迎，迎接；致敬，致意；映入眼帘 n. (Greet)人名；(英)格里特
pray|祈祷；恳求；央求 n. (Pray)人名；(匈)普劳伊；(英)普雷
brown|棕色的，褐色的；太阳晒黑的 v. 变成褐色 n. 褐色，棕色
burden|负担；责任；船的载货量 v. 使负担；烦扰；装货于
civilization|文明；文化
rate|比率，率；速度；价格；等级 v. 认为；估价；责骂
system|制度，体制；系统；方法
advertise|通知；为…做广告；使突出
metal|金属；合金 v. 以金属覆盖 adj. 金属制的
forgive|原谅；免除（债务、义务等）
fat|肥的，胖的；油腻的；丰满的 n. 脂肪，肥肉 v. 养肥；在…中加入脂肪
go|走；达到；运转；趋于 n. 去；进行；尝试
collection|采集，聚集；[税收] 征收；收藏品；募捐
rich|富有的；肥沃的；昂贵的 n. (Rich)人名；(丹)里克；(捷)里赫；(英、西)里奇；(葡、法)里什
underwear|内衣物
choke|呛；使窒息；阻塞；抑制；扑灭 n. 窒息；噎；[动力] 阻气门
oh|哦；哎呀（表示惊讶或恐惧等）
sixteenth|第十六；十六分之一 adj. 第十六的；十六分之一的
elder|老人；长辈；年长者；父辈 adj. 年长的；年龄较大的；资格老的
beauty|美；美丽；美人；美好的东西
shy|害羞的；畏缩的，胆怯的 v. 投；畏缩；惊退；厌恶 n. 投掷；惊跳
existence|存在，实在；生存，生活；存在物，实在物
run|经营；奔跑；运转 n. 奔跑；赛跑；趋向；奔跑的路程
geometry|几何学
living|活的；现存的；活跃的；逼真的 n. 生活；生存；生计 v. 生活；居住（live的ing形式）；度过
carriage|运输；运费；四轮马车；举止；客车厢
chain|链；束缚；枷锁 v. 束缚；囚禁；用铁链锁住
sweater|毛线衣，运动衫；大量出汗的人，发汗剂
lost|失去的；丧失的；迷惑的 v. 遗失（lose的过去分词）；失败
careless|粗心的；无忧无虑的；淡漠的 n. (Careless)人名；(英)凯尔利斯
river|河，江
routine|[计] 程序；日常工作；例行公事 adj. 日常的；例行的
gymnastics|体操；体育；体操运动
storage|存储；仓库；贮藏所
within|在…之内 adv. 在内部 n. 里面
queen|女王，王后；（纸牌中的）皇后；（蜜蜂等的）蜂王 v. 使…成为女王或王后
wheat|小麦；小麦色
number|数；（杂志等的）期；号码；数字；算术 v. 计入；总数达到
palace|宫殿；宅邸；豪华住宅
childhood|童年时期；幼年时代
violate|违反；侵犯，妨碍；亵渎
tale|故事；传说；叙述；流言蜚语
society|社会；交往；社团；社交界
restrict|限制；约束；限定
speech|演讲；讲话；[语] 语音；演说
harvest|收获；产量；结果 v. 收割；得到
recorder|录音机；记录器；记录员；八孔直笛
be|是； 有，存在； 做，成为； 发生 n. (Be)人名；(缅)拜；(日)部(姓)；(朝)培；(中非)贝
son|儿子；孩子（对年轻人的称呼）；男性后裔
attitude|态度；看法；意见；姿势
ad|公元；广告（ad）
altitude|高地；高度；[数] 顶垂线；（等级和地位等的）高级；海拔
everything|每件事物；最重要的东西；（有关的）一切；万事
upper|上面的，上部的；较高的 n. (Upper)人名；(英)厄珀
trunk|树干；躯干；象鼻；汽车车尾的行李箱 vt. 把…放入旅行箱内 adj. 干线的；躯干的；箱子的
other|其他的，另外的 pron. 另外一个
tram|电车轨道；煤车 v. 用煤车运载
debate|辩论，争论，讨论 n. 辩论；辩论会
sell|销售；推销；出卖；欺骗 n. 销售；失望；推销术
belief|相信，信赖；信仰；教义
bookcase|[家具] 书柜，书架
ninth|第九 adj. 第九的；九分之一的 n. 九分之一
hardworking|努力工作的；不辞辛劳的，苦干的 v. 努力工作（hardwork的ing形式）
unrest|不安；动荡的局面；不安的状态
prejudice|偏见；侵害 v. 损害；使有偏见
dial|转盘；刻度盘；钟面 v. 拨号
variety|多样；种类；杂耍；变化，多样化
wipe|擦；消除；涂上 n. 擦拭；用力打
peach|桃子；桃树；桃红色；受人喜欢的人（或物） adj. 桃色的；用桃子制成的 v. 告密
third|第三；三分之一 adj. 第三的；三分之一的
tube|管；电子管；隧道；电视机 v. 使成管状；把…装管；用管输送
delighted|高兴的；欣喜的 v. 使…兴高采烈；感到快乐（delight的过去分词）
why|哎呀！什么？ adv. 为什么
control|控制；管理；抑制；操纵装置 v. 控制；管理；抑制
saturday|星期六
alley|小巷；小路；小径
home|家，住宅；产地；家乡；避难所 adv. 在家，回家；深入地 adj. 国内的，家庭的；有效的 v. 归巢，回家
smog|烟雾
survive|幸存；生还；幸免于；比活得长
stewardess|女管家；女干事；女服务员
snow|雪，积雪；下雪 v. 降雪
cool|凉爽的；冷静的；出色的 v. 使…冷却；使…平静下来 n. 凉爽；凉爽的空气 adv. 冷静地
useless|无用的；无效的
secure|安全的；无虑的；有把握的；稳当的 v. 保护；弄到；招致；缚住
pipe|管；烟斗；笛 v. 吹笛；尖叫
minibus|面包车（等于microbus）；小型公共汽车；中客车 vi. 乘中客车
me|我（宾格） n. 自我；极端自私的人；自我的一部分
arrival|到来；到达；到达者
conservative|保守的 n. 保守派，守旧者
however|无论如何；不管怎样（接副词或形容词）；然而；可是 conj. 无论以何种方式; 不管怎样
mature|成熟的；充分考虑的；到期的；成年人的 v. 成熟；到期
guide|指南；向导；入门书 v. 引导；带领；操纵
traffic|交通；运输；贸易；[通信] 通信量 v. 用…作交换；在…通行
block|块；街区；大厦；障碍物 v. 阻止；阻塞；限制；封盖 adj. 成批的，大块的；交通堵塞的
happy|幸福的；高兴的；巧妙的 n. (Happy)人名；(英、瑞典、喀)哈皮
elect|选出的；当选的；卓越的 n. 被选的人；特殊阶层；上帝的选民 v. 选举；选择；推选
august|威严的；令人敬畏的 n. 八月（简写为Aug）
past|过去；往事 adj. 过去的；结束的 prep. 越过；晚于 adv. 过；经过
saying|话；谚语；言论 v. 说（say的ing形式）
hello|喂；哈罗 n. 表示问候， 惊奇或唤起注意时的用语
repeat|重复；复制；背诵 n. 重复；副本
separately|分别地；分离地；个别地
cave|使凹陷，使塌落；在…挖洞穴 n. 洞穴，窑洞
urge|力劝，催促；驱策，推进 n. 强烈的欲望，迫切要求；推动力
whistle|口哨；汽笛；呼啸声 v. 吹口哨；鸣汽笛
instruction|指令，命令；指示；教导；用法说明
postcard|明信片
civil|公民的；民间的；文职的；有礼貌的；根据民法的 n. (Civil)人名；(土)吉维尔；(法)西维尔
knowledge|知识，学问；知道，认识；学科
fantasy|幻想；白日梦；幻觉 adj. 虚幻的 v. 空想；想像
airline|航空公司；航线 adj. 航线的
till|[地理][水文] 冰碛；放钱的抽屉；备用现金 prep. 直到 conj. 直到为止 v. 耕种；犁
sixteen|十六的，十六个的 num. 十六
born|出世（bear的过去分词） adj. 天生的 n. (Born)人名；(柬)邦；(英、西、俄、捷、德、瑞典、匈)博恩
actual|真实的，实际的；现行的，目前的
wage|进行；发动；从事 n. 工资；代价；报偿
aeroplane|飞机（等于airplane）
word|[语] 单词；话语；消息；诺言；命令 v. 用言辞表达
significance|意义；重要性；意思
quantity|量，数量；大量；总量
shock|休克；震惊；震动；打击；禾束堆 v. 使休克；使震惊；使震动；使受电击；把…堆成禾束堆 adj. 浓密的；蓬乱的
recognise|认出；承认，认可；识别
twice|两次；两倍
special|特使，特派人员；特刊；特色菜；专车；特价商品 adj. 特别的；专门的，专用的
major|主要的；重要的；主修的；较多的 n. [人类] 成年人；主修科目；陆军少校 v. 主修
minimum|最小值；最低限度；最小化；最小量 adj. 最小的；最低的
earthquake|地震；大动荡
troublesome|麻烦的；讨厌的；使人苦恼的
skillful|熟练的；巧妙的
away|离去，离开；在远处
anger|怒，愤怒；忿怒 v. 使发怒，激怒；恼火
spade|铁锹，铲子 v. 铲；把……弄实抹平
section|截面；部分；部门；地区；章节 v. 被切割成片；被分成部分
railway|（英）铁路；轨道；铁道部门 vi. 乘火车旅行
comment|评论；意见；批评 v. 发表评论；发表意见
salute|致敬，欢迎；敬礼 v. 行礼致敬，欢迎
part|部分；角色；零件；一些；片段 v. 分离；分配；分开 adv. 部分地 adj. 部分的
hate|憎恨；厌恶；遗憾 n. 憎恨；反感
thirsty|口渴的，口干的；渴望的，热望的
enterprise|企业；事业；进取心；事业心
freeze|冻结；冷冻；僵硬 n. 冻结；凝固
candle|蜡烛；烛光；烛形物 v. 对着光检查
campaign|作战；参加竞选；参加活动 n. 运动；活动；战役
vast|广阔的；巨大的；大量的；巨额的 n. 浩瀚；广阔无垠的空间
maple|枫树；淡棕色
benefit|利益，好处；救济金 v. 有益于，对…有益
neither|也不；既不 adv. 两个都不；既不……也不 adj. 两者都不的 pron. 两者都不
sword|刀，剑；武力，战争
desire|欲望；要求，心愿；性欲 v. 想要；要求；希望得到…
relief|救济；减轻，解除；安慰；浮雕
catch|赶上；抓住；感染；了解 n. 捕捉；捕获物；窗钩
consult|查阅；商量；向…请教
preserve|保存；保护；维持；腌；禁猎 n. 保护区；禁猎地；加工成的食品
next|然后；下次；其次 adj. 下一个的；其次的；贴近的 n. 下一个 prep. 靠近；居于…之后
numb|使麻木；使发愣；使失去感觉 adj. 麻木的；发愣的
one|一个人；任何人 adj. 一的；唯一的 n. 一 num. 一；一个
shoe|鞋；蹄铁；外胎 v. 给……穿上鞋；穿……鞋
so|如此，这么；确是如此 conj. 所以；因此 pron. 这样 n. (So)人名；(柬)索
husband|节约地使用（或管理） n. 丈夫
occur|发生；出现；存在
prescription|药方；指示；惯例 adj. 凭处方方可购买的
spoonful|一匙；一匙的量
mankind|人类；男性
slip|滑动；滑倒；犯错；失足；减退 n. 滑，滑倒；片，纸片；错误；下跌；事故 adj. 滑动的；有活结的；活络的 abbr. 串行线路接口协议，是旧式的协议（Serial Line Interface Protocol）
eastern|东方的；朝东的；东洋的 n. 东方人；（美国）东部地区的人
thought|思想；思考；想法；关心 v. 想，思考；认为（think的过去式和过去分词）
cattle|牛；牲畜（骂人的话）；家畜；无价值的人
dumpling|饺子，汤团；面团布丁
accountant|会计师；会计人员
path|道路；小路；轨道
veal|小牛（等于vealer）；小牛肉
initial|最初的；字首的 v. 用姓名的首字母签名 n. 词首大写字母
medium|中间的，中等的；半生熟的 n. 方法；媒体；媒介；中间物
beat|打；打败 n. 拍子；敲击；有规律的一连串敲打 adj. 筋疲力尽的；疲惫不堪的
background|背景；隐蔽的位置 v. 作…的背景 adj. 背景的；发布背景材料的
caution|小心，谨慎；警告，警示 v. 警告
beef|牛肉；肌肉；食用牛；牢骚 v. 抱怨，告发；发牢骚
belgium|比利时（西欧国家，首都布鲁塞尔Brussels）
stare|凝视，盯着看；显眼 n. 凝视；注视
mistake|错误；误会；过失 v. 弄错；误解
freedom|自由，自主；直率
fountain|喷泉，泉水；源泉
bakery|面包店
juice|（水果）汁，液；果汁
similar|相似的 n. 类似物
pond|筑成池塘 vi. 筑成池塘 n. 池塘
swim|游泳；漂浮；浸；眩晕 n. 游泳；漂浮；眩晕 adj. 游泳时穿戴的
tonight|在今晚 n. 今晚
apart|相距；与众不同地；分离着 adj. 分离的；与众不同的
fly|飞；驾驶飞机；飘扬 n. 飞行；苍蝇；两翼昆虫 adj. 敏捷的
undertake|承担，保证；从事；同意；试图
punctuate|不时打断；强调；加标点于
brick|砖，砖块；砖形物；心肠好的人 v. 用砖砌 adj. 用砖做的；似砖的
dictionary|字典；词典
carrier|[化学] 载体；运送者；带菌者；货架
quake|震动；颤抖 n. 地震；颤抖
medal|勋章，奖章；纪念章
theatre|电影院，戏院；戏剧；阶梯式讲堂
shot|发射；炮弹；射手；镜头 adj. 用尽的；破旧的；杂色的，闪光的 v. 射击（shoot的过去式和过去分词）
roof|屋顶；最高处，顶部；最高限度 v. 给…盖屋顶，覆盖
harmful|有害的；能造成损害的
socialist|社会主义者；社会党党员 adj. 社会主义的
ring|按铃；敲钟；回响；成环形 n. 戒指；铃声，钟声；拳击场；环形物
supermarket|超级市场；自助售货商店
pattern|模式；图案；样品 v. 模仿；以图案装饰
kite|风筝 v. 使用空头支票；像风筝一样飞；轻快地移动
remark|注意；言辞 v. 评论；觉察
greedy|贪婪的；贪吃的；渴望的
savage|野蛮的；残酷的；狂怒的；荒凉的 n. 未开化的人；粗鲁的人；残暴成性的人 v. 乱咬；粗暴的对待
novelist|小说家
close|紧密的；亲密的；亲近的 v. 关；结束；使靠近 adv. 紧密地 n. 结束
northwest|西北的；向西北的；来自西北的 n. 西北 adv. 在西北；向西北；来自西北
not|表示否定，不 n. “非”（计算机中逻辑运算的一种）
grateful|感谢的；令人愉快的，宜人的
unknown|未知的；陌生的，默默无闻的 n. 未知数；未知的事物，默默无闻的人
pump|打气；用抽水机抽… n. 泵，抽水机；打气筒
publicly|公然地；以公众名义
fortunate|幸运的；侥幸的；吉祥的；带来幸运的
assist|帮助；助攻 v. 参加；出席
weak|[经] 疲软的；虚弱的；无力的；不牢固的
accommodation|住处，膳宿；调节；和解；预订铺位
kettle|壶；[化工] 釜；罐；鼓
easter|复活节
result|结果；成绩；答案；比赛结果 v. 结果；导致；产生
japanese|日本（人）的；日语的 n. 日本人；日语
simple|简单的；单纯的；天真的 n. 笨蛋；愚蠢的行为；出身低微者
president|总统；董事长；校长；主席
mark|标志；马克；符号；痕迹；分数 v. 作记号
tournament|锦标赛，联赛；比赛
musical|音乐的；悦耳的 n. 音乐片
invite|邀请，招待；招致 n. 邀请
merely|仅仅，只不过；只是
punctuation|标点；标点符号
stay|停留；坚持；暂住；停下 n. 逗留；停止；支柱
examine|检查；调查； 检测；考试
difference|差异；不同；争执
than|比（用于形容词、副词的比较级之后）；除…外（用于other等之后）；与其…（用于 rather等之后）；一…就（用于 no sooner等之后） prep. 比；超过 n. (Than)人名；(老、柬、德)坦；(缅)丹
poster|海报，广告；招贴
rice|稻；米饭 v. 把…捣成米糊状
hooray|呼万岁 vt. 呼万岁 n. 万岁 int. 万岁
hay|干草 v. 把晒干
construction|建设；建筑物；解释；造句
art|艺术；美术；艺术品 adj. 艺术的；艺术品的 v. 是（be的变体）
crossing|十字路口；杂交；横渡；横道 v. 横越（cross的现在分词）
whisper|私语；谣传；飒飒的声音 v. 耳语；密谈；飒飒地响
consensus|一致；舆论；合意
secretary|秘书；书记；部长；大臣
midday|中午；正午 adj. 正午的
every|每一的，每个的；每隔…的 n. (Every)人名；(英)埃夫里
until|在…以前；直到…时 prep. 在…以前；到…为止
gay|快乐的；放荡的；艳丽的 n. 同性恋者
virtue|美德；优点；贞操；功效
glance|一瞥；一滑；闪光 v. 扫视，匆匆一看；反光；瞥闪，瞥见
conflict|冲突，矛盾；斗争；争执 v. 冲突，抵触；争执；战斗
telephone|（美）电话；电话机；电话耳机 v. 打电话
bell|铃，钟；钟声，铃声；钟状物 v. 装钟于，系铃于
cold|寒冷的；冷淡的，不热情的；失去知觉的 n. 寒冷；感冒 adv. 完全地
dance|舞蹈；舞会；舞曲 v. 跳舞；跳跃；飘扬 adj. 舞蹈的；用于跳舞的
bank|银行；岸；浅滩；储库 v. 将…存入银行；倾斜转弯
thread|线；螺纹；思路；衣服；线状物；玻璃纤维；路线 v. 穿过；穿线于；使交织
skilled|熟练的；有技能的；需要技能的
boxing|拳击；装箱；围模；做箱的材料 v. 将…装入盒中（box的ing形式）
air|空气，大气；天空；样子；曲调 v. 使通风，晾干；夸耀
exist|存在；生存；生活；继续存在
tobacco|烟草，烟叶；烟草制品；抽烟
snatch|抢夺；抓举；小量 v. 夺得；抽空做；及时救助
three|三，三个 num. 三 adj. 三的，三个的
double|两倍；双精度型 adj. 双重的；两倍的 v. 加倍，加倍努力；快步走 adv. 双重地；两倍地；弓身地
invention|发明；发明物；虚构；发明才能
printing|印刷；印刷术
worthless|无价值的；不值钱的；卑微的
tortoise|龟，[脊椎] 乌龟（等于testudo）；迟缓的人
because|因为
dirty|下流的，卑鄙的；肮脏的；恶劣的；暗淡的 v. 弄脏
supply|供给，补给；供应品 v. 供给，提供；补充
inform|通知；告诉；报告
responsibility|责任，职责；义务
class|阶级；班级；种类；班；等级 v. 分类；把…分等级；把…归入某等级，把…看作（或分类、归类）；把…编入某一班级 adj. 极好的；很好的，优秀的，出色的
frontier|前沿；边界；国境 adj. 边界的；开拓的
dine|进餐，用餐 n. (Dine)人名；(意、葡)迪内；(英)戴恩；(法)迪纳
life|生活，生存；寿命
child|儿童，小孩，孩子；产物；子孙；幼稚的人；弟子
un|联合国（United Nations）；硝酸铀铣（Uranyl Nitrate）
overweight|超重的；过重的 vt. 使负担过重 n. 超重
important|重要的，重大的；有地位的；有权力的
fist|拳，拳头；〈口〉笔迹；掌握；[印]指标参见号 vt. 紧握；握成拳；用拳打
factory|工厂；制造厂；代理店
division|[数] 除法；部门；分配；分割；师（军队）；赛区
wrist|手腕；腕关节 vt. 用腕力移动
hundred|一百；许多 adj. 一百的；许多的 num. 百；百个
chat|聊天；闲谈 n. 聊天；闲谈
bring|带来；促使；引起；使某人处于某种情况或境地 n. (Bring)人名；(英、瑞典)布林
amaze|使吃惊
village|村庄；村民；（动物的）群落
journalist|新闻工作者；报人；记日志者
symbol|象征；符号；标志
spirit|精神；心灵；情绪；志气；烈酒 v. 鼓励；鼓舞；诱拐
kick|踢；反冲，朝后座 n. 踢；反冲，后座力
ice|冰；冰淇淋；矜持；（俚）钻石 v. 冰镇；结冰 adj. 冰的
distinguish|区分；辨别；使杰出，使表现突出
gesture|姿态；手势 v. 作手势；用动作示意
tokyo|东京（日本首都）
puzzled|困惑的；茫然的；搞糊涂的
respond|回答；作出反应；承担责任 n. 应答；唱和
latest|最迟地；最后地 n. 最新的事物 adj. 最新的，最近的；最迟的，最后的
pride|自豪；骄傲；自尊心 v. 使得意，以…自豪
uk|联合王国（United Kingdom） n. 英国
wind|风；呼吸；气味；卷绕 v. 缠绕；上发条；使弯曲；吹号角；绕住或缠住某人
split|分离；使分离；劈开；离开；分解 n. 劈开；裂缝 adj. 劈开的
and|和，与；就；而且；但是；然后 n. (And)人名；(土、瑞典)安德
handsome|（男子）英俊的；可观的；大方的，慷慨的；健美而端庄的
left|左边的；左派的；剩下的 adv. 在左面 n. 左边；左派；激进分子 v. 离开（leave的过去式）
storm|暴风雨；大动荡 v. 起风暴；横冲直撞；狂怒咆哮
shirt|衬衫；汗衫，内衣
seventeen|十七，十七个 adj. 十七岁的；十七的，十七个的 num. 十七
unhealthy|不健康的；危险的；有害身心健康的
lap|一圈；膝盖；下摆；山坳 v. 使重叠；拍打；包围
neighbourhood|邻近；周围；邻居关系；附近一带
used|习惯的；二手的，使用过的 v. 用（use的过去式）；（used to）过去常做
windy|多风的，有风的；腹胀的；吹牛的
murder|谋杀，凶杀 n. 谋杀，凶杀
nation|国家；民族；国民
cake|蛋糕；块状物；利益总额 v. 使结块
often|常常，时常
accompany|陪伴，伴随；伴奏
subscribe|订阅；捐款；认购；赞成；签署
relation|关系；叙述；故事；亲属关系
anywhere|在任何地方；无论何处 n. 任何地方
dilemma|困境；进退两难；两刀论法
beard|公然反对；抓…的胡须 n. 胡须；颌毛
though|可是，虽然；不过；然而 conj. 虽然；尽管 prep. 但
bow|弓；鞠躬；船首 v. 鞠躬；弯腰 adj. 弯曲的
many|许多；许多人 adj. 许多的 n. (Many)人名；(法)马尼
what|什么；多么；多少 adj. 什么；多么；何等 adv. 到什么程度，在哪一方面 int. 什么；多么
shooting|射击；打猎；摄影；射门 v. 射击（shoot的ing形式）
government|政府；政体；管辖
right|正确的；直接的；右方的 v. 复正；恢复平稳 n. 正确；右边；正义 adv. 正确地；恰当地；彻底地
cash|现款，现金 v. 将…兑现；支付现款
chest|胸，胸部；衣柜；箱子；金库
advise|建议；劝告，忠告；通知；警告
sad|难过的；悲哀的，令人悲痛的；凄惨的，阴郁的（形容颜色）
another|又一，另一；另外的；不同的 pron. 另一个；又一个 prep. 另一个；另一个人
pole|杆；极点；电极 v. 用竿支撑
average|平均；平均数；海损 adj. 平均的；普通的；通常的 v. 算出…的平均数；将…平均分配；使…平衡
capital|首都，省会；资金；大写字母；资本家 adj. 首都的；重要的；大写的
sit|坐；位于 n. (Sit)人名；(东南亚国家华语)硕；(罗)西特
stain|沾污；败坏；给…着色 n. 污点；瑕疵；着色剂
aluminium|铝的 n. 铝
conventional|符合习俗的，传统的；常见的；惯例的
prepare|准备；使适合；装备；起草
elegant|高雅的，优雅的；讲究的；简炼的；简洁的
present|提出；介绍；呈现；赠送 adj. 现在的；出席的 n. 现在；礼物；瞄准
bachelor|学士；单身汉；（尚未交配的）小雄兽
religious|宗教的；虔诚的；严谨的；修道的 n. 修道士；尼姑
mailbox|邮箱；邮筒
dizzy|晕眩的；使人头晕的；昏乱的；心不在焉的；愚蠢的 v. 使头晕眼花；使混乱；使茫然 n. (Dizzy)人名；(英)迪齐
chopsticks|筷子
accustomed|习惯的；通常的；独有的 v. 使习惯于（accustom的过去分词）
ancient|古代的；古老的，过时的；年老的 n. 古代人；老人
acquire|获得；取得；学到；捕获
regardless|不管的；不顾的；不注意的 adv. 不顾后果地；不管怎样，无论如何；不惜费用地
firefighter|消防队员
pineapple|[园艺] 菠萝；[园艺] 凤梨 adj. 凤梨科的
impossible|不可能的；不可能存在的；难以忍受的；不真实的 n. 不可能；不可能的事
classmate|同班同学
pop|卖点广告（Point of Purchase）
contribute|贡献，出力；投稿；捐献
license|执照，许可证；特许 v. 许可；特许；发许可证给
peaceful|和平的，爱好和平的；平静的
probable|很可能的；可信的 n. 很可能的事；大有希望的候选者
admire|钦佩；赞美
identity|身份；同一性，一致；特性；恒等式
observe|庆祝
profession|职业，专业；声明，宣布，表白
with|用；随着；支持；和…在一起 n. (With)人名；(德、芬、丹、瑞典)维特
minister|部长；大臣；牧师 v. 执行牧师职务；辅助或伺候某人
enough|足够地，充足地 n. 很多；充足 adj. 充足的 int. 够了！
cup|杯子；奖杯；酒杯 v. 使成杯状；为…拔火罐
gy|灰色（gray）；圭亚那（Guyana） n. 戈瑞
movement|运动；活动；运转；乐章
ending|结局；结尾
centigrade|摄氏的；[仪] 摄氏温度的；百分度的
ceremony|典礼，仪式；礼节，礼仪；客套，虚礼
point|要点；得分；标点；[机] 尖端 v. 指向；弄尖；加标点于
sniff|嗅；嗤之以鼻 n. 吸，闻；嗤之以鼻；气味；以鼻吸气；吸气声
annoy|骚扰；惹恼；打搅 n. 烦恼（等于annoyance）
architecture|建筑学；建筑风格；建筑式样；架构
television|电视，电视机；电视业
editor|编者，编辑；社论撰写人；编辑装置
criminal|罪犯 adj. 刑事的；犯罪的；罪恶的
dialogue|对话；意见交换 vi. 对话 vt. 用对话表达
per|每；经；按照；每一 n. (Per)人名；(德、挪、丹、瑞典)佩尔
programme|计划，规划；节目；程序 v. 编程序；制作节目
menu|菜单
pancake|薄烤饼；粉饼；平降（全称pancake landing） vi. 平坠着陆；平展 vt. 使平坠著陆；使平展
her|她（she的宾格）；她的（she的所有格）；她（指某个国家；一艘船） n. （法）埃尔（人名）
mist|薄雾；视线模糊不清；模糊不清之物 v. 下雾；变模糊
pace|一步；步速；步伐；速度 v. 踱步；缓慢而行
story|故事；小说；新闻报道；来历；假话 vt. 用历史故事画装饰 vi. 说谎
regret|遗憾；抱歉；悲叹 v. 后悔；惋惜；哀悼
grocer|杂货店；食品商
celebration|庆典，庆祝会；庆祝；颂扬
build|建立；建筑 n. 构造；体形；体格
smoke|烟；抽烟；无常的事物 v. 冒烟，吸烟；抽烟；弥漫
confuse|使混乱；使困惑
cottage|小屋；村舍；（农舍式的）小别墅
manage|管理；经营；控制；设法
lovely|可爱的；令人愉快的；爱恋的；秀丽的，优美的 n. 美女；可爱的东西
rude|粗鲁的；无礼的；狂暴的；未开化的 n. (Rude)人名；(英、西、瑞典)鲁德；(法)吕德
nursing|护理；看护；养育 v. 看护；养育（nurse的ing形式）
compensate|补偿，赔偿；抵消
yourselves|你们自己；你们本人（yourself的复数）
always|永远，一直；总是；常常
origin|起源；原点；出身；开端
distinction|区别；差别；特性；荣誉、勋章
begin|开始 n. (Begin)人名；(以、德)贝京；(英)贝让
garlic|大蒜；蒜头
tailor|剪裁；使合适 n. 裁缝
off|离开；脱落 adv. 切断；走开 adj. 远离的；空闲的
unit|单位，单元；装置；[军] 部队；部件
allergic|对…过敏的；对…极讨厌的
finger|手指；指针，指状物 v. 伸出；用手指拨弄
upstairs|在楼上，向楼上；上楼；往楼上 adj. 楼上的 n. 楼上
misunderstand|误解；误会
cater|投合，迎合；满足需要；提供饮食及服务 n. (Cater)人名；(英)凯特
riddle|解谜；给出谜；充满于 n. 谜语；粗筛；谜一般的人、东西、事情等
huge|巨大的；庞大的；无限的 n. (Huge)人名；(英)休奇
centimetre|厘米；公分
more|更多；此外；更大程度地 adj. 更多的；附加的 pron. 更多的数量 n. 更多
unable|不会的，不能的；[劳经] 无能力的；不能胜任的
telescope|压缩；使套叠 n. 望远镜；缩叠式旅行袋
castle|城堡；象棋中的车 v. 置…于城堡中；筑城堡防御
noisy|嘈杂的；喧闹的；聒噪的
which|哪/那一个；哪/那一些 adj. 哪一个；哪一些
equip|装备，配备
rain|雨；下雨；雨天；雨季 v. 下雨；降雨
hill|小山；丘陵；斜坡；山冈
doctor|修理；篡改，伪造；为…治病；授以博士学位 n. 医生；博士
incorrect|错误的，不正确的；不适当的；不真实的
help|帮助；促进；治疗；补救 n. 帮助；补救办法；帮忙者；有益的东西
room|房间；空间；余地；机会；房间里所有的人 v. 为…提供住处；租房，合住；投宿，住宿；留…住宿
park|公园；[交] 停车场 v. 停放；放置；寄存
idiom|成语，习语；土话
beneficial|有益的，有利的；可享利益的
incident|事件，事变；插曲 adj. [光] 入射的；附带的；易发生的，伴随而来的
text|[计] 文本；课文；主题 v. 发短信
strength|力量；力气；兵力；长处
their|他们的，她们的；它们的 n. (Their)人名；(英)蒂尔；(芬、瑞典)泰尔
material|重要的；物质的，实质性的；肉体的 n. 材料，原料；物资；布料
receipt|收到；收据；收入 v. 收到
actor|男演员；行动者；作用物
globe|地球；地球仪；球体 vt. 使…成球形 vi. 成球状
chief|首领；酋长；主要部分 adj. 首席的；主要的；主任的 adv. 主要地；首要地
politics|政治，政治学；政治活动；政纲
heart|心脏；感情；勇气；心形；要点 vt. 鼓励；铭记 vi. 结心
chew|咀嚼；咀嚼物 v. 嚼碎，咀嚼
extension|延长；延期；扩大；伸展；电话分机
botanical|植物学的 n. 植物性药材
lame|跛足的；僵痛的；不完全的；无说服力的；差劲的，蹩脚的 v. 变跛
rectangle|矩形；长方形
thief|小偷，贼
brand|铭刻于，铭记；打烙印于；印…商标于 n. 商标，牌子；烙印
litter|垃圾；轿，担架；一窝（动物的幼崽）；凌乱 v. 乱丢；给…垫褥草；把…弄得乱七八糟
sneaker|运动鞋；卑鄙者；鬼鬼祟祟做事的人
abstract|摘要；抽象；抽象的概念 adj. 抽象的；深奥的 v. 摘要；提取；使……抽象化；转移(注意力、兴趣等)；使心不在焉
nowadays|现今；时下 n. 当今
unimportant|不重要的；琐碎的
just|只是，仅仅；刚才，刚刚；正好，恰好；实在；刚要 adj. 公正的，合理的；正直的，正义的；正确的；公平的；应得的 n. (Just)人名；(英)贾斯特；(法)朱斯特；(德、匈、波、捷、挪)尤斯特；(西)胡斯特
acknowledge|承认；答谢；报偿；告知已收到
enlarge|扩大；放大；详述
switzerland|瑞士（欧洲国家）
conclusion|结论；结局；推论
theirs|他们的；她们的；它们的
labourer|劳动者；劳工
forbid|禁止；不准；不允许；〈正式〉严禁
weekly|每周的；周刊的；一周一次的 n. 周刊 adv. 每周一次；逐周
skip|跳跃；跳绳；遗漏；跳读 n. 跳跃；跳读
something|某事；某物 n. 重要的人；值得重视的事 adv. 非常；有点；大约 adj. 大约；有点象
themselves|他们自己；他们亲自
net|网；网络；净利；实价 v. 编网 adj. 纯粹的；净余的
rail|铁轨；扶手；横杆；围栏 v. 抱怨；责骂
interrupt|中断；打断；插嘴；妨碍 n. 中断
case|情况；实例；箱 v. 包围；把…装于容器中
bless|祝福；保佑；赞美 n. (Bless)人名；(英、意、德、匈)布莱斯
shoot|射击，射中；拍摄；发芽；使爆炸；给…注射 n. 射击；摄影；狩猎；急流
upward|向上的；上升的 adv. 向上
atmosphere|气氛；大气；空气
consistent|始终如一的，一致的；坚持的
organization|组织；机构；体制；团体
each|每；各自的 adv. 每个；各自 pron. 每个；各自
stone|石头；结石；[宝] 宝石 adj. 石的，石制的 v. 向扔石块；用石头铺
afternoon|午后，下午
loud|大声的，高声的；不断的；喧吵的 adv. 大声地，高声地，响亮地 n. (Loud)人名；(英)劳德
foot|脚；英尺；步调；末尾 v. 步行；跳舞；总计
sunglasses|太阳镜；凸透镜（sunglass的复数）
hilly|丘陵的；陡的；多小山的；多坡的 n. (Hilly)人名；(阿拉伯)希利
command|命令，指挥；控制 n. 指挥，控制；命令；司令部
string|线，弦，细绳；一串，一行
thus|因此；从而；这样；如此 conj. 因此 n. 乳香
percent|百分比，百分率；部分；百分数 adj. 百分之…的 adv. 以百分之…地
banana|香蕉；喜剧演员；大鹰钩鼻
thick|最拥挤部分；活动最多部分；事物的粗大浓密部分 adj. 厚的；浓的；粗大的 adv. 密集地；浓浓地，厚厚地
far|很；遥远地；久远地；到很远的距离；到很深的程度 adj. 远的；久远的 n. 远方
astronaut|宇航员，航天员；太空旅行者
much|非常，很 adj. 大量的 n. 许多，大量 pron. 许多，大量
security|安全；保证；证券；抵押品 adj. 安全的；保安的；保密的
rigid|严格的；僵硬的，死板的；坚硬的；精确的
keeper|监护人；饲养员；看守人；管理人
backward|向后的；反向的；发展迟缓的 adv. 向后地；相反地
uncle|叔叔；伯父；伯伯；舅父；姨丈；姑父
reality|现实；实际；真实
rot|腐烂；腐败；腐坏 v. 腐烂；腐败；堕落 int. （表示厌恶、蔑视、烦恼等）胡说；糟了
receive|收到；接待；接纳
bee|蜜蜂，蜂；勤劳的人
appreciation|欣赏，鉴别；增值；感谢
chairman|主席，会长；董事长
swift|褐雨燕 adj. 快的；迅速的；敏捷的；立刻的 adv. 迅速地
lavatory|厕所，盥洗室
judge|判断；审判 n. 法官；裁判员
tough|艰苦的，困难的；坚强的，不屈不挠的；坚韧的，牢固的；强壮的，结实的 n. 恶棍 v. 坚持；忍受，忍耐 adv. 强硬地，顽强地
biochemistry|生物化学
dull|钝的；迟钝的；无趣的；呆滞的；阴暗的 v. 使迟钝；使阴暗；缓和 n. (Dull)人名；(罗、匈)杜尔；(柬)杜；(英)达尔
king|国王；最有势力者；王棋 vi. 统治；做国王 vt. 立…为王 adj. 主要的，最重要的，最大的
crash|撞碎；坠毁；破产；轰隆声；睡觉 v. 摔碎；坠落；发出隆隆声；(金融企业等)破产
church|教堂；礼拜；教派 adj. 教会的；礼拜的 v. 领…到教堂接受宗教仪式
language|语言；语言文字；表达能力
boundary|边界；范围；分界线
cheat|欺骗；骗取 n. 欺骗，作弊；骗子
cocoa|可可粉；可可豆；可可饮料；深褐色
idea|想法；主意；概念
climb|爬；攀登；上升 n. 爬；攀登
upset|使心烦；颠覆；扰乱 adj. 心烦的；混乱的；弄翻的 n. 混乱；翻倒；颠覆
thursday|星期四
performance|性能；绩效；表演；执行；表现
appeal|呼吁，恳求；上诉；诉诸，求助；有吸引力，迎合爱好；（体育比赛中）诉诸裁判 n. 呼吁，请求；吸引力，感染力；上诉；诉诸裁判
national|国家的；国民的；民族的；国立的 n. 国民
socket|插座；窝，穴；牙槽 vt. 给…配插座
burglar|夜贼，窃贼
owner|[经] 所有者；物主
grow|发展；生长；渐渐变得… n. (Grow)人名；(英)格罗
beautiful|美丽的
fierce|凶猛的；猛烈的；暴躁的 n. (Fierce)人名；(英)菲尔斯
pedestrian|徒步的；缺乏想像力的 n. 行人；步行者
court|法院；球场；朝廷；奉承 v. 招致（失败、危险等）；向…献殷勤；设法获得
badminton|羽毛球
postbox|邮箱
photo|照片
onion|洋葱；洋葱头
meat|肉，肉类（食用）
atlantic|大西洋 adj. 大西洋的
voyage|航行；航程；旅行记 v. 航行；航海
excellent|卓越的；极好的；杰出的
telegraph|[通信] 电报机，电报 v. 电汇；流露出；打电报给…
breakthrough|突破；突破性进展
cause|原因；事业；目标 v. 引起；使遭受
swap|交换；交换之物 v. 与交换；以作交换
nervous|神经的；紧张不安的；强健有力的
thorough|彻底的；十分的；周密的
seal|密封；印章；海豹；封条；标志 v. 密封；盖章
tissue|组织；纸巾；薄纱；一套 v. 饰以薄纱；用化妆纸揩去
damp|使潮湿；使阻尼；使沮丧，抑制 n. 潮湿，湿气 adj. 潮湿的
condemn|谴责；判刑，定罪；声讨
yawn|哈欠；裂口 v. 打哈欠；裂开
biology|（一个地区全部的）生物；生物学
announcement|公告；宣告；发表；通告
punish|惩罚；严厉对待；贪婪地吃喝
army|陆军，军队
hunger|饿，饥饿；渴望 v. 渴望；挨饿
businesswoman|女商人
well|很好地；充分地；满意地；适当地 adj. 良好的；健康的；适宜的 n. 井；源泉 v. 涌出
airplane|飞机
boss|老板；首领；工头 v. 指挥，调遣；当…的领导
warm|温暖的；热情的 v. 同情；激动；变温暖 n. 取暖；加热
figure|数字；人物；图形；价格；（人的）体形；画像 v. 计算；出现；扮演角色
condition|条件；情况；环境；身份 v. 决定；使适应；使健康；以…为条件
bus|公共汽车
works|作品；工厂；工程结构
bargain|交易；便宜货；契约 v. 讨价还价；议价；(谈价钱后)卖
dynamic|动态的；动力的；动力学的；有活力的 n. 动态；动力
song|歌曲；歌唱；诗歌；鸣声
goal|目标；球门，得分数；终点 vi. 攻门，射门得分
grain|粮食；颗粒；[作物] 谷物；纹理 v. 成谷粒
add|加；增加；加起来；做加法 n. 加法，加法运算
premier|第一的；最初的 n. 总理，首相
starve|饿死；挨饿；渴望
himself|他自己；他亲自，他本人
pie|馅饼；饼图；爱说话的人 vt. 使杂乱
slave|奴隶；从动装置 v. 苦干；拼命工作
december|十二月
budget|预算，预算费 v. 安排，预定；把…编入预算 adj. 廉价的
dinner|晚餐，晚宴；宴会；正餐
patience|耐性，耐心；忍耐，容忍
should|应该；就；可能；将要
mistaken|错误的；弄错的；被误解的 v. 弄错（mistake的过去分词）
adjust|调整，使…适合；校准
possession|拥有；财产；领地；自制；着迷
blanket|毛毯，毯子；毯状物，覆盖层 adj. 总括的，全体的；没有限制的 v. 覆盖，掩盖；用毯覆盖
ashamed|惭愧的，感到难为情的；耻于……的
crowded|拥挤的；塞满的 v. 拥挤（crowd的过去分词）
long|长时间；[语] 长音节；（服装的）长尺寸；长裤 adj. 长的；过长的；做多头的；长时间的；冗长的，长音 v. 渴望；热望 adv. 长期地；始终
review|回顾；复习；评论；检讨；检阅 v. 回顾；检查；复审
shine|发出光；反射光，闪耀；出类拔萃，表现突出；露出；照耀；显露；出众 n. 光亮，光泽；好天气；擦亮；晴天；擦皮鞋；鬼把戏或诡计
rid|使摆脱；使去掉 n. (Rid)人名；(英)里德
learn|学习；得知；认识到
disagreement|不一致；争论；意见不同
lose|浪费；使沉溺于；使迷路；遗失；错过 n. (Lose)人名；(英)洛斯；(德)洛泽
graduate|授予…学位；分等级；标上刻度 n. 研究生；毕业生 adj. 毕业的；研究生的
everybody|每个人；人人
describe|描述，形容；描绘
especially|特别；尤其；格外
tuesday|星期二
crossroads|十字路口；交叉路口；聚会的中心地点（crossroad的复数形式）
soon|快；不久，一会儿；立刻；宁愿
inspect|检查；视察；检阅
protection|保护；防卫；护照
fasten|使固定；集中于；扎牢；强加于 n. (Fasten)人名；(英)法森
deeply|深刻地；浓浓地；在深处
tanker|油轮；运油飞机；油槽车；坦克手
lion|狮子；名人；勇猛的人；社交场合的名流
skill|技能，技巧；本领，技术
familiar|熟悉的；常见的；亲近的 n. 常客；密友
silence|沉默；寂静；缄默；不谈；无声状态 v. 使沉默；使安静；压制；消除噪音 int. 安静！；别作声！
send|发送，寄；派遣；使进入；发射 n. 上升运动
birthday|生日，诞辰；诞生的日子
compare|比较 v. 比拟，喻为；[语]构成
illness|病；疾病
universal|普遍的；通用的；宇宙的；全世界的；全体的 n. 一般概念；普通性
arise|出现；上升；起立 n. (Arise)人名；(西)阿里塞；(日)在濑(姓)
reason|理由；理性；动机 v. 推论；劝说
picture|照片，图画；影片；景色；化身 v. 画；想像；描写
lack|缺乏；不足；没有；需要 n. 缺乏；不足
westerner|西方人，欧美人；美国西部的人
unless|除非，如果不 prep. 除…之外
everyday|每天的，日常的 n. 平时；寻常日子
gift|礼物；天赋；赠品 v. 赋予；向…赠送
soap|肥皂 v. 将肥皂涂在……上；对……拍马屁（俚语）
painting|绘画；油画；着色 v. 绘画（paint的ing形式）；涂色于
advance|发展；前进；增长；预付款 v. 提出；预付；使……前进；将……提前 adj. 预先的；先行的
sex|性；性别；性行为；色情 v. 引起…的性欲；区别…的性别
thunderstorm|[气象] 雷暴；雷暴雨；大雷雨
privilege|特权；优待 v. 给与…特权；特免
personal|个人的；身体的；亲自的 n. 人事消息栏；人称代名词
introduction|介绍；引进；采用；入门；传入
carpet|在…上铺地毯，把地毯铺在…上；斥责 n. 地毯；地毯状覆盖物
chemistry|化学；化学过程
hear|听到，听；听说；审理
combine|使化合；使联合，使结合 n. 联合收割机；联合企业
smelly|有臭味的，发臭的
tourism|旅游业；游览
japan|日本（东亚国家名）
affection|喜爱，感情；影响；感染
locust|[植保] 蝗虫，[昆] 蚱蜢
accuse|控告，指控；谴责；归咎于
beam|横梁；光线；电波；船宽；[计量] 秤杆 v. 发送；以梁支撑；用…照射；流露
embarrass|使局促不安；使困窘；阻碍
businessman|商人
bat|蝙蝠；球棒；球拍；批处理文件的扩展名 v. 用球棒击球；击球率达…
english|英国人的；英国的；英文的 n. 英语；英国人；英文；英格兰人 vt. 把…译成英语
reference|参考，参照；涉及，提及；参考书目；介绍信；证明书 v. 引用
beer|啤酒 vi. 喝啤酒
public|公众的；政府的；公用的；公立的 n. 公众；社会；公共场所
breathe|呼吸；低语；松口气；（风）轻拂
eggplant|茄子 adj. 深紫色的
cousin|堂兄弟姊妹；表兄弟姊妹
push|推动，增加；对…施加压力，逼迫；按；说服 n. 推，决心；大规模攻势；矢志的追求
tolerate|忍受；默许；宽恕
golden|金色的，黄金般的；珍贵的；金制的 n. (Golden)人名；(英、法、罗、德、瑞典)戈尔登
waitress|女服务员；女侍者 v. 做女服务生
senior|高级的；年长的；地位较高的；年资较深的，资格较老的 n. 上司；较年长者；毕业班学生
false|错误的；虚伪的；伪造的 adv. 欺诈地
february|二月
suffering|受难；苦楚 adj. 受苦的；患病的 v. 受苦；蒙受（suffer的ing形式）
peace|和平；平静；和睦；秩序
astronomer|天文学家
biscuit|小点心，饼干
reuse|重新使用，再用 v. 再使用
rope|绳，绳索 v. 捆，绑
radio|收音机；无线电广播设备 v. 用无线电进行通信
cent|分；一分的硬币；森特（等于半音程的百分之一）
refreshments|点心；[食品] 茶点；小吃
vital|至关重要的；生死攸关的；有活力的 n. (Vital)人名；(法、德、意、俄、葡)维塔尔；(西)比塔尔
settlement|解决，处理；[会计] 结算；沉降；殖民
pot|壶；盆；罐 v. 把…装罐；射击；节略
windbreaker|防风夹克，同windcheater
frog|青蛙；[铁路] 辙叉；饰扣 v. 捕蛙
sure|确信的；可靠的；必定的 adv. 当然；的确 n. (Sure)人名；(英)休尔
poor|贫穷的；可怜的；贫乏的；卑鄙的 n. (Poor)人名；(英、伊朗)普尔
soft|软的，柔软的；温柔的，温和的；软弱的；笨的 adv. 柔软地；温和地 n. 柔性；柔软的东西；柔软部分
relevant|相关的；切题的；中肯的；有重大关系的；有意义的，目的明确的
limit|限制；限度；界线 v. 限制；限定
sow|播种；散布；使密布 n. 母猪
usual|通常的，惯例的；平常的
jazz|爵士乐，爵士舞；喧闹 v. 奏爵士乐，跳爵士舞；游荡 adj. 爵士乐的；喧吵的
century|世纪，百年；（板球）一百分
tea|茶叶；茶树；茶点 vt. 给…沏茶 vi. 喝茶；进茶点
corner|角落，拐角处；地区，偏僻处；困境，窘境 v. 囤积；相交成角
fiction|小说；虚构，编造；谎言
understand|理解；懂；获悉；推断；省略
mean|平均的；卑鄙的；低劣的；吝啬的 v. 意味；想要；意欲 n. 平均值
resist|抵抗，抗拒；忍耐 n. [助剂] 抗蚀剂；防染剂
playmate|玩伴；游伴
fault|故障；[地质] 断层；错误；缺点；毛病；（网球等）发球失误 v. 弄错；产生断层
thriller|惊险小说；使人毛骨悚然的东西；使人毛骨悚然的小说
message|消息；差使；启示；预言；广告词 v. 报信，报告；[通信] 报文
theme|主题；主旋律；题目 adj. 以奇想主题布置的
am|调频，调谐，调幅（ amplitude modulation） v. （用于第一人称单数现在时） aux. （与v-ing连用构成现在进行时，与v-ed连用构成被动语态） n. （柬）安（人名）
accuracy|[数] 精确度，准确性
balloon|激增；膨胀如气球 n. 气球 adj. 像气球般鼓起的
you|你；你们 n. (You)人名；(柬)尤；(东南亚国家华语)猷
oil|油；石油；油画颜料 v. 加油；涂油；使融化
departure|离开；出发；违背
eighth|第八的；八分之一的 num. 第八；八分之一
corporation|公司；法人（团体）；社团；大腹便便；市政当局
salesman|推销员；售货员
chorus|合唱队；齐声；歌舞队 v. 合唱；异口同声地说
competition|竞争；比赛，竞赛
boat|小船；轮船 v. 划船
fur|皮，皮子；毛皮；软毛 v. 用毛皮覆盖；使穿毛皮服装
trainer|助理教练；训练员；驯马师；飞行练习器；运动鞋
encourage|鼓励，怂恿；激励；支持
road|公路，马路；道路；手段 vt. （狗）沿臭迹追逐（猎物） adj. （美）巡回的
punishment|惩罚；严厉对待，虐待
place|地方；住所；座位 v. 放置；任命；寄予
parking|停车 adj. 停车的 v. 停车（park的ing形式）
machine|机械，机器；机构；机械般工作的人 v. 用机器制造
tell|告诉，说；辨别；吩咐；断定 n. (Tell)人名；(英、德、瑞典)特尔；(罗、意)泰尔；(阿拉伯)塔勒
think|想；认为；想起；想像；打算 n. 想；想法 adj. 思想的
nearby|附近的，邻近的 adv. 在附近 prep. 在…附近
human|人的；人类的 n. 人；人类
range|范围；幅度；排；山脉 v. （在内）变动；平行，列为一行；延伸；漫游；射程达到
complex|复杂的；合成的 n. 复合体；综合设施
fever|发烧，发热；狂热 vt. 使发烧；使狂热；使患热病 vi. 发烧；狂热；患热病
royal|皇家的；盛大的；女王的；高贵的；第一流的 n. 王室；王室成员
brave|勇敢的；华丽的 v. 勇敢地面对 n. 勇士
irrigate|灌溉；冲洗；使清新
desert|遗弃；放弃；逃跑 n. 沙漠；荒原；应得的赏罚 adj. 沙漠的；荒凉的；不毛的
urban|城市的；住在都市的 n. (Urban)人名；(西)乌尔万；(斯洛伐)乌尔班；(德、俄、罗、匈、塞、波、捷、瑞典、意)乌尔班；(英)厄本；(法)于尔邦
splendid|辉煌的；灿烂的；极好的；杰出的
asian|亚洲人 adj. 亚洲的；亚洲人的
conversation|交谈，会话；社交；交往，交际；会谈；（人与计算机的）人机对话
rescue|营救；援救 n. 营救；援救；解救
microcomputer|微电脑；[计] 微型计算机
lamp|灯；照射器 vt. 照亮 vi. 发亮
lecture|演讲；讲稿；教训 v. 演讲；训诫
teacher|教师；导师
beg|乞讨；恳求；回避正题 n. (Beg)人名；(德、塞、巴基)贝格
trust|信任，信赖；责任；托拉斯 v. 信任，信赖；盼望；赊卖给
strike|打，打击；罢工；敲，敲击；抓；打动；穿透 n. 罢工；打击；殴打
thermos|热水瓶
amateur|爱好者；业余爱好者；外行 adj. 业余的；外行的
march|三月
its|它的 n. (Its)人名；(俄)伊茨
phone|电话；耳机，听筒 v. 打电话
province|省；领域；职权
workplace|工作场所；车间
play|游戏；扮演；演奏；播放；同…比赛 n. 游戏；比赛；剧本
reply|回答；[法] 答辩；回击 n. 回答；[法] 答辩
department|部；部门；系；科；局
intention|意图；目的；意向；愈合
tutor|辅导；约束 n. 导师；家庭教师；助教
graduation|毕业；毕业典礼；刻度，分度；分等级
spear|矛，枪 v. 用矛刺
communication|通讯，[通信] 通信；交流；信函
plant|工厂，车间；植物；设备；庄稼 v. 种植；培养；栽培；安置
listen|听，倾听；听从，听信 n. 听，倾听
this|这；这个；这里 adj. 这；本；这个；今 adv. 这样地；这么 n. (This)人名；(法)蒂斯
decide|决定；解决；判决
empire|帝国；帝王统治，君权
worker|工人；劳动者；职蚁
weekday|平日，普通日；工作日
controversial|有争议的；有争论的
company|公司；陪伴，同伴；连队 v. 交往
spanish|西班牙的；西班牙人的；西班牙语的 n. 西班牙语；西班牙人
mile|英里；一英里赛跑；较大的距离
dry|干的；口渴的；枯燥无味的；禁酒的 v. 把…弄干 n. 干涸
skirt|裙子 v. 绕过，回避；位于…边缘
sign|迹象；符号；记号；手势；指示牌 v. 签署；签名
playroom|游戏室；娱乐室
hole|洞，孔；洞穴，穴；突破口 v. 凿洞，穿孔；（高尔夫球等）进洞
fingernail|手指甲
spoon|匙，勺子；一杓的量 v. 用匙舀；使成匙状
assess|评定；估价；对…征税
middle|中间的，中部的；中级的，中等的 n. 中间，中央；腰部
cartoon|卡通片，[电影] 动画片；连环漫画 v. 为…画漫画
mail|邮件；邮政，邮递；盔甲 v. 邮寄；给…穿盔甲
cafeteria|自助餐厅
violinist|小提琴演奏者，小提琴家
unpleasant|讨厌的；使人不愉快的
relationship|关系；关联
receiver|接收器；接受者；收信机；收款员，接待者
health|健康；卫生；保健；兴旺
pea|豌豆
grill|烧，烤； n. 烤架，铁格子；烤肉
softball|垒球；垒球运动
seaweed|海藻，海草
coral|珊瑚；珊瑚虫 adj. 珊瑚的；珊瑚色的
rush|冲进；匆促；急流；灯心草 adj. 急需的 v. 使冲；突袭；匆忙地做；飞跃
narrow|狭窄的，有限的；勉强的；精密的；度量小的 n. 海峡；狭窄部分，隘路 v. 使变狭窄
boot|引导；踢；解雇；使穿靴 n. 靴子；踢；汽车行李箱
claw|爪；螯，钳；爪形器具 v. 用爪抓（或挖）
answer|回答；符合 n. 回答；答案；答辩
own|拥有；承认 adj. 自己的；特有的 n. 自己的
rhyme|韵律；韵脚；韵文；押韵词 v. 使押韵；用韵诗表达；把…写作诗
likely|很可能的；合适的；有希望的 adv. 很可能；或许
plain|平的；简单的；朴素的；清晰的 n. 平原；无格式；朴实无华的东西 adv. 清楚地；平易地
frenchman|法国人
socialism|社会主义
experience|经验；经历；体验 v. 经验；经历；体验
awful|可怕的；极坏的；使人敬畏的
applicant|申请人，申请者；请求者
speak|说话；演讲；表明；陈述
saleswoman|[贸易] 女售货员；[贸易] 女店员
twelfth|第十二的，第十二个的；十二分之一的 n. 第十二；月的第十二日
nail|钉；使固定；揭露 n. [解剖] 指甲；钉子
fancy|幻想；想象力；爱好 adj. 想象的；奇特的；昂贵的；精选的 v. 想象；喜爱；设想；自负
disability|残疾；无能；无资格；不利条件
besides|此外；而且 prep. 除…之外
beginning|开始；起点 v. 开始；创建（begin的ing形式）
rock|岩石；摇滚乐；暗礁 v. 摇动；使摇晃
betray|背叛；出卖；泄露（秘密）；露出…迹象
soil|土地；土壤；国家；粪便；务农；温床 v. 弄脏；污辱
sunset|日落，傍晚
allow|允许；给予；认可
clerk|职员，办事员；店员；书记；记账员；<古>牧师，教士 v. 当销售员，当店员；当职员
chant|圣歌；赞美诗 v. 唱；诵扬
cloudy|多云的；阴天的；愁容满面的
here|在这里；此时 int. 嘿！；喂！ n. 这里
price|价格；价值；代价 v. 给……定价；问……的价格
bride|新娘；姑娘，女朋友
challenge|挑战；怀疑 v. 向…挑战；对…质疑
painful|痛苦的；疼痛的；令人不快的
cushion|垫子；起缓解作用之物；（猪等的）臀肉；银行储蓄 v. 给…安上垫子；把…安置在垫子上；缓和…的冲击
oilfield|油田
fit|安装；使……适应；使……合身；与……相符 adj. 健康的；合适的；恰当的；准备好的 n. 合身；发作；痉挛
value|值；价值；价格；重要性；确切涵义 v. 评价；重视；估价
scene|场面；情景；景象；事件
freezing|冰冻的；严寒的；冷冻用的
wild|野生的；野蛮的；狂热的；荒凉的 n. 荒野 adv. 疯狂地；胡乱地
scenery|风景；景色；舞台布景
sideway|人行道；小巷 adv. 斜地里 adj. 旁边的；向侧面的（等于sideways）
squid|鱿鱼；乌贼；枪乌贼
convenient|方便的；[废语]适当的；[口语]近便的；实用的
dark|黑暗的，深色的；模糊的；无知的；忧郁的 n. 黑暗；夜；黄昏；模糊
zero|零点，零度 num. 零
interesting|有趣的；引起兴趣的，令人关注的
chips|[食品] 炸土豆条；小木片；（作赌注用的）圆形筹码；缺口（chip的复数形式）
sugar|糖；食糖；甜言蜜语 v. 加糖于；粉饰
silk|丝绸；蚕丝；丝织物 adj. 丝的；丝绸的；丝制的 vi. （玉米）处于长须的阶段中
nod|点头；打盹；摆动 v. 点头；点头表示
float|使漂浮；实行 n. 彩车，花车；漂流物；浮舟；浮萍
believe|信任；料想；笃信宗教
mom|妈妈
june|六月；琼（人名，来源于拉丁语，含义是“年轻气盛的六月”）
treatment|治疗，疗法；处理；对待
sight|视力；景象；眼界；见解 v. 看见；瞄准 adj. 见票即付的；即席的
calm|静的，平静的；沉着的 v. 使平静；使镇定 n. 风平浪静
plenty|丰富，大量；充足 adj. 足够的，很多的 adv. 足够
missile|导弹；投射物 adj. 导弹的；可投掷的；用以发射导弹的
environment|环境，外界
anyone|任何人；任何一个
clearly|清晰地；明显地；无疑地；明净地
climate|气候；风气；思潮；风土
behave|表现；（机器等）运转；举止端正；（事物）起某种作用
delete|删除
call|呼叫；拜访；叫牌 n. 电话；呼叫；要求；访问
catastrophe|大灾难；大祸；惨败
orbit|轨道；眼眶；势力范围；生活常规 v. 盘旋；绕轨道运行
customs|海关；风俗（custom的复数）；习惯；关税
snowy|下雪的，多雪的；被雪覆盖的；洁白无瑕的
waste|浪费；废物；荒地；损耗；地面风化物 v. 浪费；消耗；使荒芜 adj. 废弃的；多余的；荒芜的
regard|注意；尊重；问候；凝视 v. 注重，考虑；看待；尊敬；把…看作；与…有关
communism|共产主义
less|较少地；较小地；更小地 adj. 较少的；较小的 prep. 减去 n. 较少；较小
french|法国的；法语的；法国人的 n. 法国人；法语
reduce|减少；降低；使处于；把…分解
identification|鉴定，识别；认同；身份证明
alphabet|字母表，字母系统；入门，初步
lawyer|律师；法学家
moon|月亮；月球；月光；卫星 v. 闲荡；出神
robot|机器人；遥控设备，自动机械；机械般工作的人
nineteen|十九
sigh|叹息，叹气 n. 叹息，叹气
food|食物；养料
raise|提高；筹集；养育；升起 n. 高地；上升；加薪
strengthen|加强；巩固
league|联盟；社团；范畴 v. 使…结盟；与…联合
scissors|剪刀；剪式跳法 v. 剪开；删除（scissor的第三人称单数）
sweat|使出汗；流出；使干苦活；剥削；藉出汗减轻；焦急地期待 n. 汗；水珠；焦急；苦差使
reflect|反映；反射，照出；表达；显示;反省
deep|深处；深渊 adj. 深的；低沉的；深奥的 adv. 深入地；深深地；迟
tooth|牙齿 vt. 给……装齿 vi. 啮合
orange|橙色的；橘色的 n. 橙；橙色；桔子
prohibit|阻止，禁止
finance|财政，财政学；金融 v. 负担经费，供给…经费
rule|统治；管辖；裁定 n. 统治；规则
tank|坦克；水槽；池塘 v. 把…贮放在柜内；打败
worthy|值得的；有价值的；配得上的，相称的；可尊敬的；应…的 n. 杰出人物；知名人士
communicate|通讯，传达；相通；交流；感染
population|人口；[生物] 种群，[生物] 群体；全体居民
influence|影响；势力；感化；有影响的人或事 v. 影响；改变
oceania|大洋洲
noble|高尚的；贵族的；惰性的；宏伟的 n. 贵族 vt. 抓住；逮捕
knife|刀；匕首 v. 用刀切；（口）伤害
grandson|孙子；外孙
revolution|革命；旋转；运行；循环
clone|克隆；无性系；无性繁殖；靠营养生殖而由母体分离繁殖的植物 v. 无性繁殖，复制
post|岗位；邮件；标杆 v. 张贴；公布；邮递；布置
bunch|群；串；突出物 v. 隆起；打褶；形成一串
twenty|二十；二十年代 num. 二十 adj. 二十的
troop|军队；组；群；多数 v. 群集；成群而行；结队
kangaroo|袋鼠
dear|亲爱的；尊敬的；昂贵的 adv. 高价地；疼爱地 int. 哎呀 n. 亲爱的人
welfare|福利；幸福；福利事业；安宁 adj. 福利的；接受社会救济的
roll|卷；滚动，转动；辗 n. 卷，卷形物；名单；摇晃
explanation|说明，解释；辩解
feel|感觉；认为；触摸；试探 n. 感觉；触摸
mad|疯狂的；发疯的；愚蠢的；着迷的 n. 狂怒
squirrel|松鼠；松鼠毛皮 v. 贮藏
she|她（主格）；它（用来指雌性动物或国家、船舶、地球、月亮等） n. 女人；雌性动物
destination|目的地，终点
differ|使…相异；使…不同 n. (Differ)人名；(法)迪费
pack|包装；一群；背包；包裹；一副 v. 包装；压紧；捆扎；挑选；塞满
seaman|海员，水手；水兵
terror|恐怖；恐怖行动；恐怖时期；可怕的人
force|力量；武力；军队；魄力 v. 促使，推动；强迫；强加
discussion|讨论，议论
station|车站；驻地；地位；身份 v. 配置；安置；驻扎
business|商业；[贸易] 生意；[贸易] 交易；事情
granny|奶奶；外婆；婆婆妈妈的人
arabic|阿拉伯的；阿拉伯人的 n. 阿拉伯语
bone|骨；骨骼 v. 剔去的骨；施骨肥于
ok|好的；不错的 adv. 行；很好 int. 好；可以 v. 对…表示同意 n. 同意
bishop|（基督教的）主教；（国际象棋的）象
refusal|拒绝；优先取舍权；推却；取舍权
eager|渴望的；热切的；热心的 n. (Eager)人名；(英)伊格
cancel|取消
prepare|准备； 配制
govern|统治； 管理
surgeon|外科医生
analyse|分析； 研究
abrupt|突然的， 意外的
resemble|像， 类似
discourage|使气馁， 打消
hall|大厅， 礼堂； 门厅， 过道
pollution|污染
remote|遥远的
explanation|解释， 说明
cafeteria|自助餐厅
salary|工资， 薪水
pretend|假装， 装作
youth|青春； 青年
without|没有， 不
drunk|醉的
would|modal verb. 将，将会〔表示想做某事或认为某事会发生〕
pick|拾起， 采集； 挑选
customs|海关； 关税
calculate|计算， 核算
energy|精力； 能量
audience|观众， 听众
solid|结实的，固体的 n.  固体
thus|这样； 因而
meanwhile|同时
sniff|用力吸； 嗅， 闻
possess|占有， 拥有
require|需求； 要求
optional|可选择的； 随意的
scratch|抓，划破；乱涂 n.  乱写； 抓痕
analysis|分析； 解析
click|点击；发出滴答声 n.  滴答声
apparent|明显的， 清楚的
journalist|记者， 新闻工作者
left|向左边，在左边 adj. 左边的 n.  左， 左边
dawn|黎明， 拂晓
sideways|斜向一边的
object|反对 n.  物体； 目标； 宾语
harbour|港口
chapter|章
accessible|可使用的； 可进入的； 易接近的
flight|飞行； 航班； 楼梯的一段
hang|悬挂； 装饰； 绞死
role|[Ｃ] 角色； 作用
independent|独立的， 有主见的
carriage|四轮马车；  客车厢
defence|防御； 防护； 辩护
achieve|达到， 取得
ahead|在前， 向前
anybody|任何人， 无论谁
roll|滚动,打滚 n.  面包圈； 卷状物
turn|旋转；转变；转弯 n.  轮流
elect|选举
example|例子， 范例
result|结果， 效果
same|同样的， 同一的 n. 同样的事
selfish|自私的
after|prep&conj&adv.  在…之后， 后来
headline|标题；
connect|连接， 把…联系起来
hand|手；指针 vt.  交付； 传递
merciful|仁慈的； 宽大的
rebuild|重建
sharpen|变锐利， 削尖
committee|委员会
address|地址
union|联合， 联盟
straight|adj&adv.  直的
wipe|擦； 扫
sale|卖， 出售
component|成分； 零部件
suite|套， 组； 套间
consultant|顾问； 会诊医师
outdoors|户外的，野外的 n.  户外
throw|投， 掷， 扔
obvious|明显的， 显而易见的
arch|拱门； 拱形
discuss|讨论， 议论
standard|标准的 n. 标准，规格
violent|暴力的； 猛烈的
harmony|协调， 融洽
correct|正确的， 对的； 恰当的 vt. 改正；纠正
empty|空的 vt. 倒空
wish|n&v.  祝愿； 想要
institution|公共机构； 协会
tie|系，拴，扎 n.  关系； 领带； 绳子， 结
wise|聪明的， 明智的
ambition|雄心， 野心
tin|罐头
enlarge|扩大， 放大
besides|此外； 再说 prep. 除…以外
serious|严肃的， 严重的； 认真的
tip|告诫，提示；给小费 n.  顶端； 小费； 提示
export|出口 vt. 输出 n.  出口
conversation|谈话， 交谈
laugh|笑， 大笑 n. 笑，大笑，笑声；嘲笑
murder|n&v.  谋杀
fantasy|幻想， 白日梦
pay|付钱，给…报酬 n.  工资
check|核对；检查；批改 n.  检查； 批改
list|一览表，清单 vt.  列表
strange|奇怪的， 奇特的； 陌生的
lack|n&v.  缺乏， 缺少
toast|向…敬酒；烘，烤 n.  烤面包， 吐司； 祝酒， 祝酒词
aside|在旁边
circumstance|环境； 情况
success|成功， 成就； 成功的人
brunch|早午饭
authority|权威； 当局
creature|生物； 动物
outgoing|好交际的， 外向的； 即将离职的
tasteless|无滋味的
harm|n&vt.  伤害， 损伤
instrument|乐器； 工具， 器械
medium|中间的，中等的 n.   媒介
remove|移动， 拿走； 去除
wisdom|智慧
starvation|饥饿； 饿死
nowhere|任何地方都不； 无处
psychology|心理学
wrestle|摔跤， 格斗； 斟酌
treasure|金银财宝， 财富
multiply|相乘； 增加
live|生活，居住 adj.  活的； 直播的 vt. 过着，经历
approval|赞成； 认可； 批准
victory|[C] 胜利
mobile|活动的， 可移动的
perform|表演， 表现； 履行
evolution|进展， 演变， 进化
expose|暴露； 揭露
concentrate|集中， 聚集
cheer|n&v.  欢呼， 喝彩
with|与， 伴随； 有， 以
there|在那里 int. 那！你瞧！
permit|许可，允许 n.  许可证， 执照
well|好，充分地 adj. 健康的 int. 好吧 n.  井
suitable|合适的， 适宜的
personnel|人员， 职员
hopeless|没有希望的； 不可救药的
freeway|高速公路
fountain|喷泉； 源泉
pile|堆积，积累 n.  堆
channel|海峡； 频道； 通道
sunburnt|晒黑的， 晒伤的
focus|聚焦，集中 n.  中心， 焦点
entire|整个的， 全部的
approach|接近， 靠近 n. 方式，方法
wrist|手腕， 腕关节
experiment|实验
fierce|猛烈的， 激烈的
reservation|预订； 预约
e-mail|电子邮件 vt.  给…发电子邮件
hate|恨，讨厌，不喜欢 n.  怨恨
block|阻塞， 阻挡 n. 大块；街区
write|写
pet|宠物， 爱畜
flow|流动 n.  流， 流动
order|顺序；命令 vt.  命令； 点菜； 订货
wage|工资， 报酬
period|时期， 时代
musical|音乐的，爱好音乐的 n.  音乐剧
corporation|团体； 公司， 企业
distant|远的， 遥远的
understand|懂得， 理解
dismiss|解雇； 解散
intelligence|智力， 聪明
reform|改革， 革新 n. 改革；改善
ever|曾经； 无论何时
even|甚至，更加，还要 adj.  平坦的
restriction|限制
crazy|疯狂的
razor|剃须刀
coach|指导，训练 n.  教练； 马车； 长途车
champion|冠军， 优胜者
wait|等待 n.  等待， 等候
circuit|电路
pint|品脱； 一品脱啤酒
matter|要紧， 有重大关系 n. 事情，物质；原因
instant|立即的；速食的 n.  瞬间
personalization|个性化
shaver|电动剃须刀
top|顶部； 上面
native|本土的， 本国的
too|也； 又； 太； 很
have|帮助构成完成时态 vt. 有，使，令
violence|暴力； 强烈
roast|烤
energetic|精力旺盛的
consequence|结果， 后果
quilt|加衬芯床罩
famous|著名的， 出名的
question|询问 n.  问题
vinegar|醋
spirit|精神， 灵魂
premier|总理， 首相
produce|生产， 制造
allergic|过敏的
cheat|哄骗，欺骗，骗取 n.  骗子； 诈骗
framework|框架， 结构
regard|当做，看待 n.  关心， 注意； 致意
anecdote|轶事； 趣事
prohibit|禁止， 阻止
almost|几乎， 差不多
steward|男乘务员
fuel|燃料
manner|方式；举止；
upon|在…上面
foresee|预见， 预知
harmful|有害的； 致伤的
associate|结合； 结交
pray|祈祷， 祈求
wake|醒来， 叫醒
pin|钉住，别住 n.  别针； 胸针
academic|学术的；院校的 n.  大学教师； 学者
whether|是否
function|起作用； 行使职责 n. 功能，作用，职责；函数
raise|举起； 提高， 使升高； 饲养， 养育
spoon|勺， 匙， 调羹
quite|完全， 十分
lap|大腿；  一圈
mineral|矿物质， 矿物
representative|代表
terror|恐怖； 可怕的人
beneath|在…下方， 在…下面
everyone|每人， 人人
lay|放， 搁； 产
swap|交换
hatch|孵蛋
pardon|vt&n.  原谅， 宽恕； 对不起
plenty|充足， 大量， 丰富
tick|发出滴答声 n. 钟表的滴答声；记号
basis|[C] 基础； 根据； 原则
adventure|冒险； 奇遇
condition|条件， 状况
improve|改进， 更新
ceremony|典礼， 仪式
bingo|宾果
try|尝试， 试图； 努力
gym|体育馆； 健身房
basic|基本的 n.  要素； 基础
twist|拧，扭曲 n.  扭曲， 歪曲
unite|联合， 团结
bush|灌木丛， 矮树丛
technique|技术， 技巧
cause|原因，起因 vt.  促使， 引起
dioxide|二氧化物
wound|伤，使受伤；伤害 n.  [Ｃ] 创伤； 伤口
catastrophe|灾难； 灾祸； 横祸
busy|忙碌的
convey|搬运； 传播， 传达
extra|额外的， 外加的
design|设计；制订；筹划 n.  样式
generous|慷慨的， 大方的
land|登陆； 降落 n. 陆地
coincidence|一致； 巧合
victim|受害人， 牺牲品
department|部门；  系
possibility|可能， 可能性
direction|方向； 说明； 说明书； 指导
exhibition|展览， 展览会； 展品
burn|燃，烧，着火；使烧焦；
garlic|大蒜
alcoholic|酒精的；酒精中毒的 n.  饮酒过度的人
bachelor|学士； 单身汉
countryside|乡下， 农村
chief|主要的，首要的 n.  领导
automatic|自动的， 机械的
lamp|灯， 油灯； 光源
cry|喊叫； 哭 n. 喊；哭声
antarctic|南极的 n.  南极地区
conduct|引导； 管理
bury|埋， 葬
obey|服从， 顺从
stable|稳定的
lamb|羔羊； 羔羊肉
fantastic|极好的， 美妙的， 很棒的
changeable|易变的， 变化无常的
spoken|口语的
respond|回答； 做出反应
incident|事件
walk|走路， 步行 n. 散步
lame|跛的； 残废的
marry|和…结婚
pity|怜悯， 同情； 憾事
absorb|吸收； 吸引
supply|供给， 提供 n. 供给；供应品
uncertain|不确定的
concern|关系；关心 vt.  涉及， 关系到
circulate|使流通； 使运行
liberty|自由
recycle|再循环， 回收
let|让
state|状态；国家；州 vt.  宣称
press|压，按 n.  压， 按； 新闻界， 出版社
welcome|n&vt&adj.  欢迎
confidential|极受信任的； 秘密的
chaos|混乱
abundant|丰富的， 充裕的
want|想要， 需要
pace|步子， 步速； 节奏
ballet|芭蕾舞， 芭蕾舞剧
opposite|相反的， 对面的 n. 相反，对面；对立面，对立物
forecast|预知 vt.  预告， 预测
recognize|认出； 承认
warehouse|仓库； 大商店
pack|包装， 整理 n. 包，背包；一群
each|adj&pron.  每人， 每个， 每件
abnormal|反常的； 变态的
difference|不同
must|modal verb. 必须 n. 必须做的事；必不可少的东西
circle|围起来， 环绕 n. 圆圈
resign|辞去， 辞职
drier|烘干机， 吹风机
bathe|洗澡， 沐浴， 浸洗
polite|有礼貌的， 有教养的
cut|切，剪，削，割；删节 n.  伤口
entertainment|娱乐； 娱乐表演
probably|很可能， 大概
document|文件， 文献
aluminum|铝
ward|保卫，看护 n.  病房， 收容所
starve|饿死， 挨饿
prize|奖赏， 奖品， 奖金
accident|事故， 意外事件
clay|黏土； 泥土
moment|[C] 片刻， 瞬间， 刹那
anyway|不管怎样
promote|促进； 提升； 推销
routine|常规， 日常事务
found|成立， 建立
tear|扯破， 撕开 n.  眼泪
excuse|借口， 理由 vt.  原谅， 宽恕
attack|v&n.  攻击， 袭击
spoonful|一匙
humour|幽默， 幽默感
divorce|离婚 vt.  使离婚
currency|货币
distribute|分布； 分配
worried|担心的； 烦恼的
attach|系上， 贴上
canal|运河； 水道
shout|呼喊， 呼叫 n. [C]喊，高声呼喊
escape|v&n.  逃跑， 逃脱； 避开
flashlight|手电筒； 闪光信号
ankle|脚踝
situation|形势， 情况
think|想， 思索； 认为
receive|收到， 得到
thirst|渴， 口渴
participate|参加， 参与
surplus|剩余， 过剩
refresh|精神振作； 更新
librarian|图书管理员， 图书馆馆长
theft|盗窃案
religion|宗教
diagram|图表， 图样
claw|爪
prayer|祈祷
speech|演讲
watch|观察， 观看 n. 手表
clap|拍手， 鼓掌
quit|离开； 停止
polish|擦亮， 磨光； 润色
chart|图表； 航海图
insurance|保险
medical|医学的， 医疗的
principle|原则； 原理
till|conj&prep.  直到， 直到…为止
attend|出席， 参加； 专心， 考虑； 看护， 照料
goods|商品， 货物
lie|躺，卧，平放；位于 n. 谎言 vt.   说谎
secure|安全的， 可靠的； 放心的， 无虑的
smell|气味 v. 闻出，闻到，嗅到
used|to	v.  过去常常
unable|不能的， 不能胜任的
glare|瞪眼，怒目而视；闪耀 n.  强光
disappointed|失望的
irrigation|灌溉
late|晚， 迟 adj. 晚的，迟的
continue|延伸； 继续
shoot|射击，射中；摄影 n.  嫩枝， 苗， 芽
realize|认识到； 实现
budget|预算
actual|实际的， 现实的
tension|紧张， 不安； 拉紧， 绷紧； 压力， 张力
chest|箱子； 胸部
eastern|东方的， 东部的
marathon|马拉松
last|最近的，最近一段时间的，最近一次的 adv. 最近，上次 v. (使)持续 n. 鞋楦
adapt|适应； 改编
wash|洗涤，冲刷 n.  洗； 洗的衣服
weight|重量
doubt|n&v.  怀疑， 疑惑
cheerful|兴高采烈的， 快活的
uncomfortable|不舒服的， 不安的
develop|发展；  发育； 开发； 冲洗
misunderstand|误会， 不理解
warn|警告； 预告
measure|测量；权衡 n.  方法， 措施
guilty|有罪的， 犯法的； 内疚的
crossroads|十字路口
district|区， 地区
receipt|收据； 收到， 接收
assume|假定， 设想； 承担
swim|游泳； 游
full|完整地， 十分地 adj. 满的，充满的，完全的
basement|地下室
pepper|胡椒粉
chant|唱；歌颂 n.  圣歌， 赞美诗
capsule|胶囊； 太空舱
away|离开， 远离
memory|回忆， 记忆
concept|概念， 观念
motivation|动机
impossible|不可能的， 办不到的
effort|努力， 艰难的尝试
wave|挥手；摇动 n.  波， 波浪
disaster|灾难， 祸患
anything|某事  ； 任何事
agriculture|农业， 农学
grocer|零售商人； 食品店
ecology|生态学
stare|盯着看， 凝视
painful|痛苦的； 疼痛的
steady|稳固的； 平稳的
vote|选举， 投票
early|早， 在早期 adj. 早的，早期的
harvest|n&v.  收割； 收获
pain|疼痛；
disease|病， 疾病
start|n&v.  开始， 着手； 出发
purchase|n&vt.  购买
yet|到目前为止； 还； 仍然
engineer|工程师； 技师
pair|一双， 一对
manage|应付过去 vt. 管理；达成
equal|平等的，相等的 vt.  等于， 比得上
alike|类似于， 以同样的方式 adj. 相同的，相似的
gravity|地心引力， 重力
typical|典型的； 象征性的
bravery|勇敢， 勇气
finance|财政， 金融
parking|停车
shadow|[C] 影子， 阴影
hydrogen|氢
put|放， 摆
climb|爬， 攀登
offence|犯罪； 过错； 冒犯； 攻击
carbon|碳
circus|马戏团
controversial|争论的， 争议的
dinosaur|恐龙
enter|进入
attain|获得； 达到
trap|使陷入困境 n.  陷阱， 圈套
lonely|孤独的， 寂寞的
tram|有轨电车
pale|苍白的， 灰白的
struggle|n&v.  努力， 斗争， 挣扎
gallery|画廊， 美术品陈列室
pest|害虫
warmth|温暖， 暖和； 热烈， 热情， 热心
lesson|课； 功课； 教训
destroy|破坏， 毁坏
supreme|极度的； 极大的， 最高的
ambulance|救护车
junior|初级的； 年少的
coast|海岸， 海滨
shuttle|车辆、 飞机等
provide|提供
allocate|分配； 配给； 拨出
light|点，变亮 adj.  明亮的； 轻的； 浅色的 n. 光，灯，灯光
valuable|值钱的， 贵重的
primary|初级的； 首要的
stubborn|顽固的， 固执的； 难应付的
enterprise|企业， 事业
paperwork|文书工作
solar|太阳的
consume|消耗； 消费
triangle|三角形的 n. 三角形
competence|能力
helmet|头盔
theme|主题
consult|请教， 商议； 查询
merely|仅仅， 只不过
wealth|财富
editor|编辑
means|方法， 手段
chain|链， 链条
desire|n&v.  渴望， 期望
survive|幸存，生还 vt.  比…活得长
initial|开始的， 最初的
muddy|泥泞的，多泥的
consistent|一致的， 连贯的
sword|剑， 刀
fingernail|手指甲
permanent|永久的， 持久的
chat|聊天， 闲谈 n. 聊天，闲谈
fetch|去取来， 去请来
fellow|同伴， 伙伴
choice|选择， 抉择
travel|n&vi.  旅行
civilization|文明， 文化
before|以前 conj.  在…之前 prep. 在…以前，在…前面
fiction|小说； 虚构， 杜撰
friendly|友好的
possession|所有， 拥有； 财产， 所有物
tell|告诉， 吩咐； 辨别， 知道
replace|取代， 代替； 把…放回原处
appointment|约会
stomach|[C] 胃， 胃部
experience|经历，体验 n.  经验； 经历
listen|听， 仔细听， 留神听
hit|n&v.   打， 撞； 击中
major|主要的；成年的 n.  主修专业
interrupt|打扰， 打断
beat|打赢；跳动；敲打 n.   节拍
worldwide|遍及全球的， 世界各地的
bear|承担；忍受 n.  熊
affair|事， 事情
consider|考虑； 认为
housework|家务劳动
potential|潜在的，可能的 n.  潜力
accustomed|通常的， 习惯的
group|组， 群
jewelry|〈总称〉 珠宝， 首饰
obtain|获得， 得到
lounge|休息厅， 休息室
rugby|英式橄榄球
resist|抵抗； 挡开
format|版式， 格式
sacrifice|n&v.  牺牲， 奉献
particular|特殊的；个别的
illegal|违法的， 不合规定的
pause|n&vi.  暂停， 停止
congratulate|祝贺， 恭贺
careless|粗心的； 漫不经心的
square|平方的； 方形的 n. 广场；正方形
rainbow|彩虹； 幻想
twice|两次； 两倍
ample|充足的， 丰富的
altitude|高度； 高处
request|n&vt.  要求， 请求
classify|分类
part|分离， 分别 n. 部分；角色
percent|百分之…
point|指，指向 n.  点； 要点， 观点； 分数
paddle|划桨； 戏水 n. 桨状物；蹼
general|大体的， 总的； 一般的； 普遍的
tend|趋向， 往往是 vt. 照管，护理
frighten|使惊恐， 吓唬
relief|缓解； 轻松
boycott|n&vt.  联合抵制
dimension|尺寸， 尺度
park|公园；停车场 vt.  停放
unbelievable|难以置信的
process|加工，处理 n.  程序； 方法
deserve|应受， 值得
subscribe|捐赠； 订阅
clear|清晰的； 明亮的； 清楚的
chef|厨师
alternative|选择性的， 二者择一的
zoom|突然扩大， 使猛增
colleague|同事
diamond|钻石， 金刚石； 菱形
someone|某人； 重要人物
build|建造 n.  构造
mean|意味着， 意思是
approve|赞成； 满意 vt. 批准，通过
neither|两者都不（的），两者中无一（的） adv. 也不
earn|挣得， 赚得
glad|高兴的， 乐意的
chew|咀嚼
pedestrian|步行者， 行人
hurry|赶快；急忙 n.  匆忙， 仓促
account|总计有； 认为 n. 账目；描述
tolerate|忍受， 容忍
radioactive|放射性的
underline|在…下面划线； 强调
innocent|清白的， 无罪的； 纯真的
chopsticks|筷子
alphabet|字母表
ambiguous|暧昧的； 不明确的
advance|v&n.  推进， 前进
trip|[C] 旅行， 旅程
botanical|植物学的， 植物的
appreciate|欣赏； 感激
record|录制， 记录 n.  记录； 唱片
diverse|不同的， 多种多样的
cube|立方体， 立方
strict|严格的， 严密的
jump|跳跃； 惊起； 猛扑 n. [C]跳跃
knowledge|知识， 学问
happen|发生， 碰巧
pass|传递； 经过
past|过去的，最近的 prep.  经过； 晚于 n. 过去，往事
festival|节日
shock|使震惊 n.  震动， 冲击
delighted|高兴的， 快乐的
pancake|薄煎饼
active|积极的， 主动的
bill|钞票； 账单； 法案， 议案
whichever|不论哪个
court|法庭， 法院； 球场
whose|pron&conj.  谁的
bucket|桶； 铲斗
senior|年长的，资深的；高年级的 n.  上级， 长辈； 高年级学生
flexible|柔软的， 灵活的
relative|相对的； 比较的 n. 亲属，亲戚
attitude|态度； 看法
organ|器官
average|平均的；普通的 n.  平均数
compare|比较， 对照
sceptical|怀疑的， 怀疑论的
unwilling|不愿意， 勉强的
thriller|使人激动的人； 惊险、 恐怖、 刺激的小说、 戏剧或电影
transparent|显然的； 透明的
characteristic|特有的， 独特的， 典型的
how|怎样， 如何； 多少； 多么
grasp|抓住， 紧握； 领会
buddhism|佛教
receptionist|接待员
composition|作文； 作曲
unlike|不像， 和…不同
hearing|听力
term|学期； 术语； 条款； 项
volcano|火山
wedding|婚礼， 结婚
acquisition|获得； 获得物
rigid|刚硬的， 刚性的； 严格的
deadline|最后期限， 截止日期
spare|空闲的；多余的，剩余的 vt.  提供； 匀出， 分出
mine|我的 v. 开采，挖掘 n. 矿藏
mind|介意 n. 思想
grateful|感激的， 感谢的
business|商业， 生意； 职业， 事业
bungalow|平房
staff|全体职员
possible|可能的
partly|部分地， 在一定程度上
breathless|喘不过气来的
meet|遇见，会面；满足 n.  集会
answer|回答， 应答； 接电话 n. 答案
borrow|借用； 借
maximum|n&adj.  最大量 ， 最大限度
under|在下 prep.  在…下面， 向…下面
desert|舍弃， 遗弃 n.  沙漠
represent|代表； 表现
compete|比赛， 竞赛
die|死亡； 消失； 熄灭
radium|镭
fragrant|香的， 芬芳的
dig|挖  ， 掘
accountant|会计， 会计师
stocking|长筒袜
sometimes|有时
emergency|紧急情况或状态
promise|答应，允诺；预示 n.  答应， 允诺； 希望， 前景
dip|浸， 蘸
hold|拿， 握住； 举行
habit|习惯， 习性
passport|护照
absurd|不合理的； 荒谬的
burglar|盗贼， 窃贼
considerate|体贴的， 考虑周到的； 替人着想的
rubber|橡皮； 橡胶； 合成橡胶
legal|法律的， 法定的
underwear|内衣
talk|谈话，议论 n.  谈话， 会谈； 演讲
reply|n&vi.   回答， 答复
train|培训，训练 n.  火车
parcel|包裹
test|n&vt.  测试， 考查， 试验
journey|旅行， 路程
count|数； 计算； 有价值
graph|图表， 曲线图
upwards|向上， 往上
feast|盛宴； 节日； 令人愉悦的事情
contradictory|相互矛盾的；不一致的
take|拿走； 接受， 接纳
accompany|陪伴， 伴随； 伴奏
petrol|汽油
beneficial|有益的， 受益的
blame|n&vt.  责备， 责怪
final|最后的 n.  决赛； 期末考试
some|若干， 一些 adj. 一些，若干；有些；某一
squeeze|压榨， 挤 n. 紧握，捏
blank|空的；茫然的 n.  空格， 空白， 空白处
rather|相当， 宁可
importance|重要性
session|会议； 开庭
back|回；向后 adj. 后面的 n.  背后， 后部； 背
worthy|值得的； 相称的
endless|无止境的； 没完没了的
training|培训
expectation|预料； 期望
mist|雾
miss|错过； 想念
pound|磅； 英镑
load|担子， 货物
bite|咬，叮 n.  咬； 一口
ferry|渡船
disgusting|令人讨厌的
ignore|不理睬； 忽视
loaf|一条
reception|接待
applaud|鼓掌， 喝彩
just|刚才，恰好；只是，仅 adj.  公正的
outward|向外，在外 adj.  向外的， 外出的
notice|注意到 n. 通告，注意
yummy|美味的
holy|神圣的
relax|放松， 轻松
relay|接力；
custom|习惯， 习俗
length|长， 长度
permission|允许， 许可， 同意
grand|宏伟的， 盛大的
schedule|时刻表 vt.  安排， 排定
eastwards|向东
print|印刷
rewind|重绕； 回转
although|虽然， 尽管
material|材料， 原料； 物质
approximately|近似地， 大约
encouragement|鼓励， 支持， 促进； 起激励作用的事物
universe|宇宙
biochemistry|生物化学
iron|熨烫 n. 铁；熨斗
idiom|习语， 成语
blanket|毛毯， 毯子
hug|紧抱，拥抱 n.  拥抱
explain|解释， 说明
envy|n&v.  嫉妒， 羡慕
discount|折扣
construct|构筑； 建造
hope|n&v.  希望
attempt|vt&n.  试图， 尝试
soon|不久， 很快， 一会儿
division|除， 除法； 分开， 分割； 分界线
tablet|药片
hook|钩子 vt.  钩住， 用钩子挂
balance|使平衡； 权衡 n. 平衡
bend|弯曲； 弯腰， 屈身
action|行动
lock|锁 vt.  锁， 锁上
stadium|体育场
fear|n&v.  害怕， 恐惧， 担忧
appreciation|欣赏； 评论； 感激
electrical|与电有关的， 电气的
statue|雕像
sense|感觉， 意识
cream|奶油； 乳脂
sensitive|敏感的； 灵敏的； 易被惹恼的
being|生物， 人； 存在
vacant|空的， 空白的
afford|买得起； 有时间做； 承担得起； 提供
birthplace|出生地， 故乡
dustbin|垃圾箱
impression|印象， 感觉
interval|间歇， 间隔； 幕间休息
evaluate|评价； 估计
status|身份， 地位
upset|心烦的，苦恼的 vt.   使苦恼
dot|点， 圆点
deliver|投递  ； 交付， 给
tailor|定做 n. 裁缝
stamp|[C] 邮票
skip|跳过； 跳读
phenomenon|现象
mention|提到，说起 n.  提及
mad|发疯的； 生气的
barbecue|烤肉野餐
file|文件， 档案
laundry|洗衣店； 要洗的衣服
member|成员， 会员
brewery|啤酒厂， 酿酒厂
accumulate|堆积， 积累
crime|罪， 罪行
stand|站立 vt. 承担，忍受 n.  站； 台
surround|围绕， 包围
together|一起， 共同
pavement|人行道
cigarette|香烟
may|modal verb. 可能，也许 n. 山楂花
could|modal verb. 能，会，可以〔can 的过去式〕
forward|向前， 前进 adj. 早的；前进的
bent|爱好，嗜好 adj. 弯曲的；决心的
strike|罢工；侵袭；敲；
health|健康， 卫生
positive|积极的； 肯定的
favourite|特别喜爱的 n.  特别喜爱的人
bless|保佑， 降福
menu|菜单
pacific|太平洋的
able|有能力的； 有才干的， 有本事的
mend|修理， 修补
return|归还，返回 n.  返回， 来回
mail|邮政，邮递 vt.  〈美〉 邮寄
conscience|道德心， 良心
subject|题目， 主题； 学科； 主语； 主体
use|利用； 应用
bonus|奖金， 红利
feel|摸索，寻找 v.  觉得； 摸起来 vt. 感觉；触摸；认为
main|主要的
thrill|激动，兴奋；刺激 vt.  使激动； 使胆战心惊
serve|服务， 招待； 服役
cassette|[C]卡式盒； 暗盒
smile|n&v.  微笑
fine|好的；晴朗的；健康的 vt.  处…以罚金
find|找到， 发现； 感到
host|主人；节目主持人 vt.  招待； 主持
accelerate|加速， 促进
grain|谷物， 谷类
international|国际的
maid|女仆； 少女
credit|信用； 信赖； 贷方
oxygen|氧； 氧气
regardless|不管， 不顾； 不加理会
terrible|可怕的； 糟糕的
combine|联合， 结合
upward|向上， 往上
waste|浪费 n.  废弃物； 粪便
citizen|公民， 市民
occur|发生， 出现
comedy|喜剧
pleasant|令人愉快的， 舒适的
difficult|难的； 艰难的； 不易相处的
pressure|压； 压力； 压强
sort|分类，拣选 n.  种类， 类别
fill|填空； 装满； 充满
dentist|牙科医生
numb|麻木的
feed|喂  ， 饲  ； 吃
forget|忘记， 忘掉
professor|教授
convenient|便利的， 方便的
specialist|专家， 专科医生； 专家； 专业人员
compass|包围 n.  指南针
background|背景
true|真正的， 确实的； 正确的
adolescent|青春期的 n. [C]青少年
valley|山谷， 溪谷
position|位置； 职位
present|当前的；出席的 n.  礼物， 赠品 vt.  赠送； 介绍
laughter|笑， 笑声
since|自从…以来，自从…之后
patent|专利权
belong|属， 附属
soul|灵魂， 心灵
dangerous|危险的
certificate|证明， 证明书
mess|弄乱 n. 凌乱
sour|酸的
delete|删除
stain|污点， 瑕疵
breath|气息， 呼吸
transform|转变， 转换
advise|忠告， 劝告， 建议
repeat|重说， 重做； 重复
physical|身体的； 物理的； 客观存在的
make|制造， 做； 使成为
microwave|微波
rooster|公鸡
brochure|小册子
master|精通，掌握 n.  主人； 硕士
extraordinary|非常的； 非凡的
witness|目击，作证 n.  证人， 目击者
conventional|惯例的， 传统的； 常规的
regulation|规则， 规章
due|预期的； 约定的
ripen|成熟
puzzle|迷惑， 困扰 n. 难题；谜
evident|明显的， 显然的
accommodation|住处；工作场所
authentic|真的， 可信的
socket|插座， 插孔； 孔， 穴
biscuit|饼干
fence|栅栏， 篱笆
breast|胸部； 胸怀
mercy|怜悯
annoy|使烦恼， 使生气； 骚扰
inform|通知， 告诉
depend|依靠， 指望； 取决于
commit|犯  ， 干
about|大约；到处，周围 prep.  关于； 在附近， 在周围
scream|尖叫，尖声喊叫 n.  尖叫
sorrow|悲伤， 悲痛
cure|n&v.  治疗， 医好
danger|危险
crash|v&n.  碰撞； 坠毁
cover|盖子；罩；封面 vt.  覆盖； 掩盖； 包括； 报道
firm|坚固的； 坚定的 n. 公司，企业
character|字符； 性格
reflect|反射， 反映
contribution|贡献； 捐款
above|在上面 adj. 上面的，上述的；上文的 prep. 在…上面，在…上方；多于，大于
fire|火，火灾 vt.  点火； 射击； 解雇
stick|黏住；坚持 n.  木棒， 木棍
orbit|运行轨道
band|乐队； 带子； 镶边
height|高， 高度
spray|喷洒 n. 水雾，喷雾
distinguish|区分， 辨别
outer|外部的
invent|发明， 创造
fluent|流利的， 流畅的
wonderful|极好的
shortcoming|[C] 缺点， 短处
haircut|理发
howl|嚎叫， 嚎哭
something|某事； 某物
benefit|利益，好处 vt.  使受益
flood|淹没， 泛滥 n. 洪水
quality|质量； 品质
intention|计划， 意图， 目的
booth|岗；  亭或小隔间
rude|无礼的， 粗鲁的， 粗暴的
enthusiastic|热心的， 热情的
symptom|症状
funeral|葬礼
unique|唯一的， 独特的
except|除…之外
ministry|部门
religious|宗教的； 虔诚的
shelter|掩蔽； 隐蔽处
fact|事实， 现实
examine|检查， 诊察
scan|细看； 浏览； 扫描
fundamental|基础的， 基本的
association|联合； 联盟； 结交， 交往； 协会
believe|相信； 认为
remember|记得； 纪念
outline|大纲，轮廓；要点，概要 vt.  描绘轮廓； 略述
fade|褪色； 使消退； 枯萎
unless|如果不， 除非
glance|v&n.  扫视， 匆匆一看
free|自由的， 空闲的； 免费的
equality|平等， 同等， 均等
mix|混合， 搅拌
ought|应该，应当；大概 vi. 应该，应当；大概
dictation|听写
crayon|蜡笔； 蜡笔画
honour|尊敬，给予荣誉 n.  荣誉， 光荣
bother|烦扰， 打扰
expression|表情； 表达法， 表达方式
middle|中部的， 中间的， 中级的 n. 中间，当中
childhood|幼年时代， 童年
though|conj&adv.  虽然， 可是， 尽管
thorough|彻底的
appeal|n&v.  呼吁， 请求
everyday|日常的
stay|保持，停止，阻止 n.  逗留
appear|出现； 看来， 似乎
face|脸；面容；表情；面子；正面 vt.  面向； 面对， 朝； 正视； 面临
abandon|放弃
congratulation|祝贺，恭贺
inspire|鼓舞， 激励； 启示
afraid|害怕的， 恐惧的
progress|进展； 进行 n.  进步， 上进
geometry|几何学
invite|邀请； 招待
open|公开的；开着的 v.  打开； 公开
devote|奉献； 致力； 专心
agent|代理商
treat|对待， 看待； 治疗
abortion|流产； 堕胎
bishop|主教
suffering|痛苦，苦难
afterward|后来
reputation|名誉， 名声
project|项目， 工程
inside|在里面， 在内部 prep. 在…里面，在…之内
independence|独立
presentation|演示， 演出； 呈现， 展示
whenever|无论何时
dynasty|朝代， 王朝
bark|〔狗〕吠叫 n. 狗叫声，吠声
greedy|贪婪的
awkward|笨拙的； 难使用的
bare|赤裸的 vt. 使赤裸；露出
ruin|毁坏；毁灭
mutton|羊肉
celebrate|庆祝
admirable|令人钦佩的； 极好的
please|使人高兴， 令人满意 int. 请
look|看， 瞧； 看起来； 注意 n. [C]看，瞧
offshore|adj&adv.  近海的， 向海的
fortnight|两星期
scar|伤疤
mountainous|多山的
inspect|检查； 审视
campaign|参加活动； 作战 n. 战役；竞选活动
vital|重大的， 生死攸关的
conflict|斗争， 冲突
allow|允许， 准许
rough|粗糙的； 粗略的
knock|n&v.  敲； 打； 击
mass|众多，大量；
rule|规则，规定；统治 vt.  统治； 支配
proper|恰当的， 合适的
update|vt&n.   现代化； 更新
amateur|业余爱好的 n.  业余爱好者
poisonous|有毒的； 有害的； 致命的
condemn|谴责， 声讨
assistance|援助， 帮助
bitter|有苦味的； 痛苦的； 严酷的
speed|加速 n.  速度
gesture|姿势； 手势
admit|承认； 准许
common|普通的； 公共的； 共有的
interest|兴趣，趣味；利息 vt.  使产生兴趣
wonder|想知道；对…感到惊讶 n.  奇迹
sleepy|想睡的， 困倦的， 瞌睡的
sneeze|n&vi.  打喷嚏
bath|[C] 洗澡； 浴室； 澡盆
every|每一， 每个的； 每…
mask|戴面具； 掩饰 n. 口罩，面罩；遮盖物
thermos|热水瓶
summary|[C] 摘要， 概要
apply|申请； 应用
overlook|俯瞰； 远眺
politician|政治家
taxpayer|纳税人
indeed|确实， 实在
seagull|海鸥
artificial|人造的； 非天然的
disagree|意见不一致， 持不同意见
comment|评论； 注释 n. 评论
step|走；跨步 n.  脚步； 台阶
forever|永远地， 永恒地
mark|做记号， 标记 n. 标记；分数
base|根据地；底部 vt.  以…为基础， 基于…
employ|雇用
trend|倾向， 趋势； 时尚
achievement|[U] 完成， 达到； [C] 成就， 成绩
whole|完整的， 所有的
fair|公平的；晴朗的；白皙的 n.  集市， 展览会
during|在…期间， 在…过程中
balcony|阳台； 包厢
revolution|革命， 变革
mop|用拖把拖地 n.  拖把
consist|由…组成
preparation|准备， 预备； 准备工作， 准备措施
relation|关系； 亲属
reliable|可靠的
loss|丧失； 损耗
relate|有关； 涉及
typhoon|台风
decoration|装饰， 修饰； 勋章
eggplant|茄子
zip|拉开拉链，拉上拉链 n.  拉链
profession|职业； 专业
still|仍然， 还 adj. 静止的，平静的
worn|破烂的， 损坏的
arise|起来， 升起； 出现
dizzy|头晕目眩的
work|工作； 运作； 奏效 n. 工作；著作
lose|失去， 丢失
agree|同意； 应允
fail|失败； 不及格； 衰退
toward|向， 朝， 对于
enjoyable|愉快的； 有趣的
anyone|任何人， 无论谁
convince|使确信， 使信服
pride|自豪， 自夸 n. 自豪，骄傲
emperor|皇帝
word|单词； 言语； 消息， 音讯
theory|理论
broadcast|广播 n.  广播节目
love|爱；热爱；爱情；爱好 vt.  爱， 热爱； 很喜欢
extension|伸展， 延伸
signature|签名
steep|险峻的， 陡峭的
seize|抓住
literary|文学的
architect|建筑师； 设计师
forehead|前额
enjoy|欣赏， 享受…之乐趣； 喜欢
privilege|特权， 特别待遇
fireworks|烟火
substitute|替换
foreign|外国的
across|横过， 穿过
uniform|制服
fall|落，降落；跌倒 n.  秋季
identity|身份； 一致
violate|违反， 干扰
federal|中央的 ， 联邦的
event|事件， 大事； 竞赛
academy|学院
wherever|无论何处； 任何地方
reward|奖赏； 报答； 报酬； 回报
include|包含， 包括
alongside|adv&prep.  在旁边； 沿着
swallow|吞下；咽下 n.  燕子
agency|代理处， 经销处
abstract|抽象的 n. 抽象；概要
agenda|议程
opinion|看法， 见解
altogether|总共
appearance|出现， 露面； 容貌
culture|文化
devotion|奉献， 奉献精神
prefer|宁愿  ； 更喜欢
perfect|完美的， 极好的
butcher|屠宰，残杀 n.  肉店； 屠夫
float|漂浮， 浮动
pole|杆， 电线杆； 极
minority|少数； 少数民族
tight|adj&adv.  紧的
space|空白处； 空地； 空间； 太空
reference|涉及； 参考； 证明书
arrange|安排， 布置
from|从； 从…起； 距； 来自
alley|小巷； 弄堂； 胡同
discover|发现， 找到
bench|长凳； 工作台
commitment|承诺， 许诺； 保证； 献身； 投入
excite|刺激； 使兴奋， 使激动
rhyme|押韵； 作诗 n. 韵，押韵
spade|铲子； 纸牌中的黑桃
revision|复习， 温习； 修订
qualification|资格， 条件； 资格证书
collision|碰撞； 冲突
bridegroom|新郎
repair|修理，修补；纠正；恢复 n.  修理， 修补
advice|忠告， 劝告， 建议
frequent|经常的， 频繁的
insure|确保； 给…保险
elder|年长的 n.  长者， 前辈
error|错误
windy|多风的
oceania|大洋洲
public|公共的，公众的，国家的 n.  公众
spend|度过； 花费
barbershop|理发店
track|小道； 足迹； 轨道
value|价值，益处 vt.  估价， 评价
foggy|有雾的， 多雾的
quantity|数量
fortune|财产； 运气
advantage|优点， 好处
instead|代替， 顶替
rush|冲， 奔跑
command|n&v.  命令
expensive|昂贵的， 高消费的
cloudy|多云的， 阴天的
compulsory|必修的； 义务的
trade|贸易 vt.  买卖
dessert|甜点， 甜食
round|转过来 adj.  圆的， 球形的 prep. 环绕一周，围着
ambassador|大使
non-stop|adj&adv.  不停的， 不断的
temple|庙宇， 寺院
growth|生长； 增长
vague|含糊的， 不清楚的
communist|共产党的， 共产主义的 n. 共产主义者
fare|费用， 票
temporary|暂时的， 临时  的
desperate|令人绝望的； 不顾一切的
unrest|不安； 骚动
kangaroo|大袋鼠
accuracy|准确性
awful|糟糕的， 可怕的
handy|便利的； 手边的； 附近的
urge|催促， 力劝
via|经， 经过， 经由
score|得分 n. [Ｃ]得分，分数；二十；许多，很多
poor|贫穷的， 可怜的； 差的
graduate|毕业 n.   毕业生； 研究生
visual|视力的， 视觉的
absent|缺席的， 不在的
rag|破布， 抹布
because|因为
near|附近， 邻近 adj. 近的 prep. 在…附近，靠近
educate|教育， 培养
ashamed|惭愧的， 害臊的， 羞耻的
appendix|附录， 附属品； 阑尾
instruct|指示； 教导； 通知
excellent|极好的， 优秀的
fairly|相当； 还算； 公正地
handwriting|书法
raw|生的； 未加工的
merchant|商业的， 商人的 n. 商人，生意人
retell|重讲， 重复， 复述
ray|光辉， 光线
version|译文； 版本
exam|考试， 测试； 检查
stop|停止；阻止 n.  停；  站
nationality|国籍； 民族
guess|猜， 猜测； 认为
adolescence|青春期
aboard|prep&adv.  在船上， 上船
institute|建立， 设立 n. 协会；学院
poster|海报， 广告
shortly|不久
appropriate|适当的
criterion|标准， 规则
least|最少， 最少量
immediately|立即
symphony|交响乐
optimistic|乐观的
sleep|n&vi.  睡觉
vocabulary|词汇， 词汇表
refuse|拒绝， 不愿
aspect|方面； 外表
aggressive|侵略的； 咄咄逼人的
close|近， 靠近 adj. 近的；亲密的 v.  关， 关闭
sweep|扫除， 打扫
website|网站
learn|学，学习；得知，获悉 vt.  学， 学习， 学会， 得知
swing|挥舞，摆动 n.  秋千
ridiculous|荒谬的， 可笑的
severe|严重的
spin|纺纱；旋转 n.  旋转
grocery|杂货； 食品； 食品杂货店
communism|共产主义
spit|吐唾沫； 吐痰
anniversary|周年纪念
register|登记， 注册 n. 记录，登记簿
couple|夫妇；  对，  双
communicate|交际； 传达 ； 通信
eager|渴望的， 热切的
evidence|证据
republic|共和国
official|官方的， 政府的； 公务的 n. 官员；高级职员
acid|酸的
assessment|估价； 评价
post|岗位，职位；邮政，邮寄，邮件 vt.  投寄； 邮寄； 发布
agricultural|农业的
leave|离开； 留下； 遗忘
duck|躲避； 浸入水中 n. 鸭子
cottage|小屋； 村舍； 小别墅
tiresome|令人厌烦的， 讨厌的
finish|结束， 做完
discrimination|歧视
female|女性的，雌性的 n.  女性， 女人
melon|甜瓜
swift|快的， 迅速的
add|添加， 增加
minister|部长； 牧师
need|必须 vt. 需要modal n.  需要， 需求
cruel|残忍的， 残酷的； 无情的
erupt|喷发， 爆发
shade|阴凉处， 树荫处
often|经常地
gather|聚集； 采集
insist|坚持， 坚决认为
article|文章； 东西； 冠词
respect|尊敬，尊重；方面 vt.  尊敬， 尊重
ache|疼痛 n.  痛， 疼痛
loose|松散的； 宽松的
therefore|因此， 所以
exchange|n&v.  交换； 交流； 兑换
adjustment|调整， 调节； 校正
hesitate|犹豫， 踌躇
hardly|几乎不
bored|无聊的， 厌烦的
trust|vt&n.  相信， 信任， 信赖
income|收入， 所得
private|私人的； 私营的； 秘密的
technical|技术的， 工艺的
companion|同伴， 同事
choose|选择； 决定
directory|姓名地址录； 公司名录
peaceful|和平的， 安宁的
prevent|防止， 阻止
behave|表现； 行为得体
accomplish|完成， 达到
disturbing|令人不安的； 引起烦恼的
engine|发动机， 引擎
photographer|摄影师
end|结束，终止 n.  终点； 结束
mistake|弄错 n.  错误
pour|倾泻， 不断流出
message|消息， 留言； 要旨
praise|n&vt.  赞扬， 表扬
significance|意义， 重要性
special|特别的； 专门的
scissors|剪刀
environment|环境
truth|事实； 真理
clone|n&v.  克隆， 无性繁殖
betray|出卖， 背叛
pronounce|发音
family|家； 家人
swear|发誓， 诅咒
gift|赠品； 礼物； 天赋， 才能
atmosphere|气氛； 大气
decorate|装饰， 修饰
education|教育， 培养
occupation|职业， 工作； 占领， 占据
tendency|[C] 倾向， 趋势
slim|苗条的， 纤细的
arithmetic|算术
caption|标题； 字幕
rid|使…摆脱
moral|道德的，精神的 n.  道德； 寓意
number|数字， 号码； 数量
explode|爆炸； 爆发
greengrocer|蔬菜水果商
punish|惩罚， 处罚
casual|偶然的， 不经意的； 非正式的； 临时的
decline|下降； 衰败； 倾斜； 谢绝
narrow|狭窄的
judge|判断，评价 n.  裁判， 法官
similar|相似的， 像
contradict|同…矛盾， 同…抵触
catholic|天主教的
shape|形状，外形 vt.  使成形； 制造， 塑造
nothing|没有东西， 没有什么； 无关紧要的东西
headmistress|女校长
anyhow|不管怎样
whistle|鸣笛， 吹口哨 n. 口哨声；汽笛声
handle|处理 n.  柄， 把手
chain|stores	 n.  连锁店
crossing|十字路口； 人行横道
tough|结实的； 棘手的
exit|出口
system|体系， 系统
giraffe|长颈鹿
spot|斑点，污点；场所，地点 vt.  沾上污渍， 弄脏； 认出， 发现
aid|帮助 n. 援助，救护；辅助器具
other|pron&adj.  其他的， 另外的
aim|计划； 瞄准； 针对 n. 目的
against|对着； 反对
confident|自信的； 确信的
cell|细胞； 蜂房； 电池
swell|肿胀， 增大
courage|勇气， 胆略
local|当地的， 地方的
remind|提醒， 使记起
crew|全体人员
valid|有效的
defeat|击败； 战胜
spear|矛
encourage|鼓励， 激励
electronic|电子的
vacation|假期， 休假
speak|说， 讲； 谈话； 发言
share|分享，共同使用 n.  一份； 股份
bureaucratic|官僚政治的
sacred|宗教的； 庄严的， 神圣的
elegant|文雅的， 雅致的
outcome|结果， 成果
curriculum|课程
satisfaction|满意
sharp|尖锐的； 敏锐的； 整点的
powerful|强有力的， 强大的； 有影响力的
slip|溜；滑动 n.  片， 纸片； 滑倒
future|将来
anchor|抛锚；停泊 n.  锚
acquaintance|相识， 熟人
novelist|小说家
royal|王室的， 皇家的； 第一流的
shake|使摇动； 震动
eyesight|视力， 视觉
semicircle|半圆
screen|幕， 荧光屏
autonomous|自治的
referee|仲裁人， 调解人； 裁判员
trial|审判； 试验
correspond|通信； 一致； 相当； 协调
undertake|承担； 保证
insect|昆虫
buffet|自助餐
entrance|入口； 入场； 入学许可
pregnant|怀孕的
all|adj&pron&adv.   全部
always|总是； 一直； 永远
border|边缘； 边境， 国界
below|在下面 prep. 在…下面
already|已经
touch|触摸，接触 n. 接触；联系 vt.  感动
shall|modal verb. 〔某事〕必定，一定〔发生〕
admission|准许进入； 承认
real|真实的， 确实的
expense|费用， 支出
unit|单元； 单位
yell|大叫， 呼喊
contemporary|当代的； 同时代的
collect|收集， 搜集
dusty|尘土般的； 尘土多的
amusement|娱乐， 消遣
boundary|边界， 分界线
shame|遗憾的事； 羞愧
rob|抢夺， 抢劫
outing|远足； 郊游
trick|[C] 诡计， 把戏
favour|恩惠； 好感； 帮助
around|在周围；在附近；大约；掉头 prep.  在…周围； 绕着
pollute|污染
disappoint|失望
rot|腐烂， 腐败
construction|建造， 建设； 建筑物
predict|预言； 预报
row|划船 n. 排，行
universal|普遍的， 全体的
abroad|到国外； 在国外
frontier|国境， 边界； 前线
subjective|主观的
deliberately|故意地
seaweed|海草， 海藻
drawer|抽屉
transport|运输； 传送器 vt.  运输， 传送
specific|特殊的； 明确的
any|任何一个； 任何一些 adj. 任何的；一些
application|申请； 申请书
freezing|冻结的； 极冷的
punctuation|标点符号
acre|英亩； 田地
whisper|n&v.  低语， 私语
appetite|食欲， 胃口
until|prep&conj.  直到…为止， 在…以前
dull|单调无味的； 阴暗的； 迟钝的
clumsy|笨拙的
reason|说服， 劝说 n. 理由，原因
thought|思考， 思想； 念头
accurate|正确的， 准确的
ring|响；打电话 n.  电话铃声； 环形物
taste|喜爱，爱好，口味 v. 有…的味道
anywhere|任何地方
bargain|讨价还价 n. 便宜货，廉价货
identification|辨认， 鉴定； 身份证明
jam|阻塞 n.  果酱； 阻塞
annual|一年一次的， 每年的
gentle|温柔的， 柔和的
cheers|干杯
boil|沸腾， 烧开； 煮
sneaker|胶底运动鞋
lightning|闪电
remain|余下，留下 v.  保持， 仍是
shabby|破旧的， 衣衫褴褛的； 不公正的， 不讲理的； 低劣的
amaze|惊奇， 惊叹， 震惊
demand|n&v.  要求， 需要
envelope|信封
slow|缓慢的 v.  放慢速度， 减缓
turkey|火鸡
grade|等级； 学年； 成绩， 分数
deposit|n&v.  存 ； 堆积
tasty|味道好的
telescope|望远镜
flash|闪光，  闪现 n. 闪，闪光，转瞬间
skillful|熟练的； 技艺精湛的； 灵巧的
continent|大陆， 大洲
accuse|控告， 谴责
maybe|可能， 大概， 也许
another|另一个 adj. 另一；别的
guarantee|vt&n.  保证， 担保
algebra|代数学
recommend|推荐
acquire|获得； 学到
worth|值得的； 价值…
helicopter|直升机
ripe|成熟的， 熟的
where|adv&conj.  那儿； 何处
disabled|残疾的
watermelon|西瓜
arm|以…装备， 武装起来 n. 手臂；支架
popular|流行的， 受欢迎的； 大众的
broken|弄坏了的， 破碎的
outwards|向外，在外 adj.  向外的， 外出的
vice|副， 次； 代替 n. 恶习；缺陷
poison|毒药
silly|傻的，愚蠢的
liberation|解放
fortunate|幸运的， 侥幸的
wrinkle|皱纹
tour|[C] 参观， 观光， 旅行
persuade|说服， 劝说； 使相信
call|叫；电话 vt.  称呼； 呼唤； 叫； 给…打电话
consensus|一致意见
such|那么，如此 pron.   人， 事物 adj. 这样的，那样的
calm|镇静的，沉着的 v.  镇静， 沉着
boring|令人厌烦的
classic|经典的， 一流的
kick|v&n.  踢
absolute|完全的， 绝对的
ask|询问； 要求
canteen|餐厅； 食堂
describe|描写， 叙述
suck|吸， 吮
dilemma|进退两难的局面
wealthy|富有的
strength|力量， 力气
dusk|黄昏
administration|管理； 行政部门
run|跑， 奔跑； 褪色； 经营， 管理
challenging|具有挑战性的
research|研究， 调查
debate|n&v.  讨论， 辩论
view|看法； 景色
either|〔两者中的〕任何一个 adv. 也(不)
furniture|〈总称〉 家具
jet|喷射 n.  喷气式飞机； 喷射
donate|捐赠， 赠送
helpful|有帮助的， 有益的
dust|灰尘， 尘土
worry|v&n.  担忧， 烦恼
cater|投合； 备办食物
imagine|想象， 设想
attractive|迷人的， 有吸引力的
superb|庄重的， 华丽的， 极好的
might|modal verb. 可以〔用于礼貌地提出建议〕 n. 力量；威力；权力
bleed|出血， 流血
catalogue|目录
whatever|conj&pron.  无论什么
decrease|减小， 减少
camp|n&vi.  野营， 宿营
difficulty|困难， 费力； 异议
volunteer|自愿 n.  志愿者
everywhere|到处
clothing|〈总称〉 衣服
aloud|大声地； 出声地
thunderstorm|雷暴， 雷雨交加
mourn|哀痛； 哀悼
next|随后，然后，下一步 adj. 最近的；紧挨着的，隔壁的；下一次 n.  下一个人
blind|瞎的， 盲的
nod|v&n.   点头
string|细绳， 线， 带
import|进口， 输入
distance|距离
occupy|占领， 占据
submit|提交， 递交
boom|发出隆隆声； 兴隆， 使繁荣 n. 繁荣；隆隆声
abolish|废止； 废除
absence|不在， 缺席； 没有
nearly|将近； 几乎
attract|吸引； 引起
show|给…看，出示，
edition|版， 版本
cautious|小心的， 谨慎的
disappear|消失
perfume|香味； 香水
shot|射击， 开枪， 开炮， 射击声； 子弹； 拍摄
conclusion|[C] 结论； 结束
nor|也不
central|中心的， 中央的； 主要的
defend|保护， 防御
arrive|到达， 达到
memorial|纪念的 n. 纪念碑，纪念物
wag|摇动， 摆动
race|赛跑， 比赛 n. 种族；比赛
introduce|介绍； 引进
greet|问候， 向…致敬
sculpture|雕塑  ， 雕像
bond|黏合； 结合 n. 联结；联结物
way|道路； 方法； 作风
target|目标， 对象； 靶子
wax|蜡， 蜡状物
grey|灰色的； 灰白的
what|pron&adj&conj.  什么
urban|城市的， 市内的
guidance|引导， 指导
refer|谈到， 提到
nervous|紧张不安的， 神经质的
duty|责任； 义务； 税
risk|冒险，风险 vt.  冒…的危险
flame|火焰， 光辉
rise|上升， 上涨
play|玩；打；播放 n.  玩耍； 戏剧
delicate|精巧的， 精致的
fancy|奇特的；空想的 n. 空想，假想 vt.  想象， 空想
bounce|使反弹； 跳跃
tissue|薄的纱织品； 薄纸；  组织
decide|决定， 下决心
rent|租用； 出租 n. 租金
when|在那时 conj. 什么时候；当…的时候
nearby|在附近 adj. 附近的
carpenter|木匠
modest|谦虚的， 谦逊的
cast|扔，抛 n.  演员表
anxious|忧虑的； 焦急的
fan|迷， 狂热的爱好者、 支持者； 风扇
slice|片， 薄片
far|adj&adv.   远的
frost|霜
catch|接住； 捉住； 赶上； 染上
fax|传真
plan|n&v.   计划， 打算
cash|现金，现钞 vt.  兑现
case|情况； 病例； 案件； 容器
generation|代， 一代
give|给， 付出
double|两倍的；双重的 v.  加倍 n. 两个；双打
downtown|n&adj.  市区 ， 闹市区
trunk|树干； 大箱子
stainless|无污染的； 无瑕疵的； 不锈的
explicit|清楚的； 直率的
rely|依赖， 依靠； 信任
phone|打电话 n.  电话； 电话机
slide|滑行，滑动 n.  幻灯片； 滑道
comfortable|舒服的； 安逸的； 舒服自在的
waist|腰部， 腰围
style|风格， 时尚
jungle|丛林， 密林
flesh|肉， 肉体
suit|适合 n.  一套
grill|烤架； 烤肉
care|介意，在乎；在意；关心 n.  照料； 保护； 小心
damage|n&v.  毁坏， 损害
guard|保卫，看守 n.  防护装置； 警戒
settle|安家，定居 vt.  解决
direct|直接的；直达的 v.  指挥， 指导
pattern|式样； 模式
exercise|锻炼 n. [C]练习；[U]锻炼
labour|劳动， 劳力
gain|获得，挣得 n.  收获
vehicle|车辆
hardship|困难， 艰辛
confuse|使糊涂； 搞乱
kilo|千克； 公斤
freedom|自由
cushion|垫子
scold|责骂， 谴责
modern|现代的， 近代的； 时尚的
physics|物理
seldom|很少， 不常
physician|医生
protect|保护
architecture|建筑， 建筑学
souvenir|纪念品， 纪念物
dial|拨
stress|压力 vt.  强调
explore|探险； 探索
more|更 pron.  更多的…； 另外的… adj. 更多的
wet|湿的
born|出生的
strawberry|草莓
electricity|电； 电流
tentative|试验性的； 试探的 n. 试验；假设
climate|气候； 风气； 环境气氛
kill|杀死， 弄死； 消磨
conductor|管理人； 指导者； 售票员， 列车员； 乐队指挥
porridge|稀饭， 粥
pleased|高兴的
certain|某些； 确定的， 无疑的； 一定会…
woolen|羊毛的， 羊毛制的
board|木板；布告牌；委员会 vt.  上
statistics|统计表， 数字， 数据
shut|（使）关[合]上，（使）关闭 adj. 关闭的，关上的
arrest|vt&n.  逮捕， 拘留
distinction|区别； 差别
widow|寡妇
mature|成熟的， 成年的
navy|海军
disability|残疾； 无能
fee|费， 费用
section|段； 部分； 部门
simple|简单的， 简易的
used|用过的； 旧的， 二手的
influence|n&vt.  影响
mustard|芥末， 芥子粉
percentage|百分率； 比例
talent|天才， 才能
few|不多， 少数 adj. 不多的，少数的
otherwise|否则， 要不然
negotiate|谈判， 协商
hunt|v&n.  寻找； 狩猎， 猎取
package|一包， 一袋， 一盒； 包裹
pronunciation|发音
kind|善良的， 亲切的， 和蔼的， 仁慈的 n. [C]种；类
survival|幸存； 生存
strait|海峡
both|两者都； 双方都 adj. 双方的
voyage|航行， 旅行
important|重要的
nutrition|营养
detective|侦探
phrase|短语， 习惯用语
personally|就自己而言
outside|在外面，向外面，出界 adj. 外面的，外表的 prep.  在…外 n. 外面，外表，外界
passer-by|过客， 过路人
keep|保留；保存；使…保持某种状态； 保持， 继续
effect|效果； 作用， 影响
affection|友爱； 爱情
yoghurt|酸乳酪
skate|溜冰， 滑冰
correction|改正
embarrass|使困窘， 使局促不安
who|谁
weigh|称量； 重
sponsor|赞助者；主办者 vt.  赞助； 主办
acute|尖锐的； 敏锐的； 严重的； 急性的
kindergarten|幼儿园
jog|慢跑
terrify|使人感到害怕， 使恐惧
contribute|捐款， 捐献
faith|信仰， 信念； 信任
insert|插入
why|为什么 interjection. 哎呀，嗨〔表示惊讶或突然意识到某事〕
remark|n&v.  陈述， 评论
forbid|禁止， 不许
microscope|显微镜
tortoise|乌龟
candidate|候选人
alone|单独的， 孤独的
database|资料库， 数据库
parallel|平行的 n. 平行线；类似
patient|耐心的 n. 病人
reject|拒绝
dialogue|对话
diet|节食 n. 饮食；节食
profit|赢利， 获益于 n. 利润，益处
win|赢得， 获胜
rest|休息， 歇息 n. 休息；剩余的部分，其余的人
move|移动， 搬动， 搬家
amount|总计；等于 n.  数量
handful|把； 少数， 少量
album|照相簿； 集邮本； 签名纪念册
electric|电的
yawn|打呵欠
say|说， 讲
also|也
terminal|终点站； 终端
enough|n&adj&adv.  足够  ； 充足
increase|增加， 繁殖 n.  增加， 加大
differ|不一致， 有区别
shine|发光； 照耀
spread|n&v.   延伸， 展开； 传播
various|各种各样的， 不同的
attention|注意； 关心
latter|后者
front|前面的；前部的 n.  前面； 前部； 前线
visit|n&v.  参观， 访问， 拜访
clinic|诊所
customer|顾客， 主顾
stupid|愚蠢的， 笨的
greeting|祝贺； 问候； 致谢
bring|拿来， 带来， 取来
beddings|被褥
awake|唤醒 adj.  醒着的
kiss|[C]吻，亲吻 vt.  吻， 亲吻
ban|禁止；取缔 n.  禁令
hamburger|汉堡包
fond|喜爱的， 爱好的
fit|适合 adj.  适合的， 健康的
offer|v&n.  提供； 提出； 出价
robot|机器人
bar|酒吧； 条， 横木； 栅栏
suffer|受苦， 遭受
fix|修理， 安装； 确定， 决定
neighbourhood|四邻， 邻近地区
complex|复杂的；联合的 n.  联合体
draft|起草 n.  草稿
honest|诚实的， 正直的
pension|养老金
assumption|假设， 假定
rank|等级， 级别； 职衔， 军衔
rubbish|垃圾； 废物
addition|增加； 加法
afterwards|后来
sure|〈口语〉 的确， 一定， 当然 adj. 确信，肯定
grow|种植；生长，发育； 渐渐变得， 变成
carve|刻； 雕刻
shrink|收缩； 缩短
ancestor|祖宗， 祖先
league|联盟， 社团
personal|个人的， 私人的
angry|生气的， 愤怒的
former|以前的， 从前的；  前者
panic|惊恐，恐慌 n.  惊慌， 恐慌
fold|折叠； 合拢； 包围
stewardess|女乘务员， 空中小姐
as|像…一样 conj. 当…时；正如；因为；尽管 prep. 作为，以…身份
delay|n&v.  拖延
at|在…； 以…
chemical|化学的 n.  化学制品
turning|拐弯处， 拐角处
peace|和平； 安宁
plant|种植；播种 n.  植物
folk|民间的
enquiry|询问
drive|驾驶， 开； 驱赶
hurt|伤害
deal|处理 n.  量， 数额； 交易
abuse|滥用 n.  辱骂， 粗话
prove|证明是， 结果是， 原来是 vt. 证明，证实
homeland|祖国
affect|影响
deaf|聋的
admire|钦佩； 羡慕
virus|病毒
amuse|使快乐， 逗乐
see|看见， 看到； 领会
search|n&v.  搜寻， 搜查
furnished|配备了家具的
responsibility|责任
sudden|突然的
fool|欺骗； 做蠢事； 游手好闲 n. 傻子，蠢人，白痴
civil|国内的； 平民的； 民事的
by|靠近； 到…时； 被； 由； 以…的标准
whom|pron&conj.  谁
indicate|指出， 显示
set|设置，调整；树立；摆放；日落 n.  一套； 设备
charge|收费；指控；索价；充电 n.  费用， 价钱
contain|包含； 包括
outstanding|突出的， 显著的； 杰出的
litter|乱丢杂物
oval|椭圆
procedure|程序， 手续
familiar|熟悉的
biography|传记
breathe|呼吸
applicant|申请人
battle|战斗； 战役
awesome|可怕的； 引起敬畏的
partner|搭档， 合作者
gifted|有天赋的， 有才华的
visa|签证
zipper|拉链
arctic|北极
unfit|不适宜的， 不相宜的
interview|n&v.  采访； 会见； 面试
clarify|澄清， 阐明
beauty|美， 美丽； 美人
beg|请求， 乞求
scare|惊吓， 威吓； 受惊
do|用以构成疑问句及否定句 vt. 做，干
observe|观察； 遵守
humorous|幽默的
garment|衣服， 外衣
rare|罕见的， 稀有的
useless|无用的
which|哪一个； 哪一些
disadvantage|不利条件； 弱点
garbage|垃圾
mainland|大陆
downstairs|在楼下， 到楼下
marble|大理石
never|决不， 从来没有
anxiety|忧虑； 焦急
piece|一块  ； 小的部分
adjust|适应； 调整， 调节
carry|携带； 搬运； 背
burst|突然发生； 爆炸
western|西方的； 西部的
debt|债务， 欠款
little|小的； 少的
however|可是， 然而， 尽管如此； 无论如何
deep|深深地； 在深处 adj. 深的；深厚的；沉睡的；渊博的
goose|鹅
forgive|原谅， 宽恕
origin|起源； 由来
for|因为， 由于 prep. 为了；在…期间；对于
mistaken|错误的
content|满意的 n.  内容； 含量
deed|行为， 事迹
burden|担子， 负担
salute|n&v.  敬礼； 问候
random|随意的， 任意的
perhaps|可能， 或许
plot|密谋 n.  情节
rate|估价； 认为 n. 比率；价格；速度
skill|技能， 技巧
trouble|问题；疾病；麻烦 vt.  使苦恼； 使忧虑； 使麻烦
unfair|不公平的， 不公正的
divide|分， 划分； 除以
contrary|相反的 n. 反面
sit|坐
digital|数字的， 数码的
over|越过 adj.  完了， 结束了 prep. 在…之上；超过
brilliant|闪耀的； 有才气的
practical|实际的； 适用的； 实用的； 应用的
pesticide|杀虫剂
bound|被束缚的；有义务的 v.  跳跃
false|假的； 不正确的
go|去，走；进行；进展； 变得， 变成
tease|取笑， 嘲弄
fork|叉； 餐叉
form|形成， 组建 n. 表格；形式；结构
publish|出版， 发行
pyramid|角锥形； 金字塔
cheque|支票
avoid|避免， 躲开， 逃避
bid|v&n.  出价， 投标
fresh|新鲜的； 不熟练的
astonish|使惊讶
withdraw|缩回， 撤回
straightforward|adj&adv.  正直的， 坦率的
very|很，非常 adj.  恰好的， 正好的
decade|十年
expert|专家， 能手
practice|实践； 练习； 惯例， 常规
select|精选的 vt. 选择，挑选，选拔
crowd|拥挤， 群聚 n. 人群；堆
sick|有病的， 患病的， 不舒服的；  呕吐的
bit|一点， 一些， 少量
welfare|福利； 安宁， 幸福
output|产量， 输出量
corner|角； 角落； 拐角
else|别的， 其他的
modem|调制解调器
majority|多数
beside|在…旁边； 靠近
join|参加， 加入； 连接； 会合
drag|拖， 拽
reduce|减少， 缩减
likely|很可能的
large|大的； 巨大的
bakery|面包店
vain|自负的； 徒劳的
ordinary|普通的， 平常的
fry|油炸， 油煎
somebody|某人； 重要人物
drink|喝 n.  饮酒
announce|宣布， 宣告
traditional|传统的
lively|活泼的； 充满生气的
operate|动手术； 操作， 运转
begin|开始， 着手
become|变得， 成为
bacterium|细菌
paragraph|段落
oilfield|油田
alive|活着的， 存在的
eventually|最终地
neighbour|邻居
tournament|比赛， 锦标赛
cycle|骑自行车，循环 n. 周期；循环 vt.  使循环
thinking|思索； 见解； 想法
literature|文学
astronomer|天文学家
prejudice|偏见， 成见
digest|消化； 领会 n.  摘要， 概要； 文摘
angle|角度
tradition|传统， 惯例
ability|能力； 才能
everything|每件事； 一切， 所有的东西
unbearable|无法忍受的
urgent|急迫的， 紧急的
programme|为…编制程序 n. 节目；项目
belief|[C] 信条， 信念， 信仰； [U] 信任， 相信
delight|快乐，乐事 vt.  使高兴， 使快乐
immigration|移民
break|打破，弄坏；撕开 n.  间歇； 休息
chain|store	 n.  连锁店
vest|背心， 内衣
change|改变；更换；兑换 n.  零钱； 变化
suggestion|[C] 建议
fluency|流利， 流畅
draw|绘画； 拉， 吸引； 提取
systematic|系统的， 有体系的
trolleybus|无轨电车
lantern|灯笼
cupboard|碗柜， 橱柜
off|prep&adv.  离开， 走开
comfort|安慰，缓和 n.  安慰， 慰问
joke|笑话
knee|膝盖
punishment|惩罚， 处罚
hide|掩饰； 隐藏
troublesome|令人烦恼的； 讨厌的
instruction|说明， 须知； 教导
report|n&vt.  报道， 报告
oral|口头的， 口述的
complete|完成的， 完整的 vt. 完成；结束
compensate|补偿， 赔偿
fun|乐趣， 娱乐
constant|经常的， 不断的
smog|烟雾
sob|n&v.   抽泣， 呜咽地说
political|政治的
while|正当…的时候；然而 n.  一小会儿
anger|愤怒
second|二等的 num. 第二 n. 秒
that|那，那个〔指已经提到或已经知道的人、事物、想法等〕 conjunction. 〔用于动词、名词或形容词后引导一个从句，表示某人所说或所想，或陈述一个事实或理由〕 adv. 那么〔大、多等〕〔尤指通过手势比画来表示大小、数量等〕
edge|边缘
download|n&vt.  下载
split|撕开， 切开
than|比
limit|限制， 限定； 减少
widespread|分布广的
antique|古董
sow|播种
different|不同的， 有差异的
fasten|扎牢， 扣住
porter|搬运工
level|平坦的 n. 水平线，水平
dirt|污物， 脏物； 尘土
videophone|可视电话
preserve|保护， 保存
plus|加， 加上
relevant|有关的
license|执照， 许可证
entry|进入； 入口
expand|发展 vt. 扩张
dream|梦 v. 梦想，希望
noble|高贵的， 贵族的
plug|把…塞住；接通电源 n.  塞子， 插头
bunch|串， 束
spy|侦探， 刺探 n. 密探，间谍
postpone|推迟， 延期
tense|紧张的；拉紧的 n.  时态
bride|新娘
heat|加热 n. 热
behind|在后面； 向后 prep. 在…后面
hammer|敲， 锤击 n. 锤子，锣锤
seal|海豹
recipe|食谱
ambassadress|大使夫人； 女大使
mental|精神的， 脑力的
bow|v&n.  鞠躬， 弯腰
storage|贮藏， 储存； 存放
racial|种族的
switch|v&n.  更换， 转换
total|总数的；总括的；完全的 n. 合计 vt.  合计为
of|…的
reserve|n&vt.  保留， 储备； 预订
somehow|以某种方式； 不知怎么地
brick|砖； 砖块
dive|跳水
heap|堆起来 n. 堆
sympathy|同情
hear|听见， 听说， 得知
fight|n&v.   打仗， 打架； 争论
roundabout|绕道的；不直接的 n.  转盘路
rescue|vt&n.  营救， 援救
facial|面部用的
on|继续 prep. 在…上；在…时候；在…地方；关于
zebra|斑马
brief|简洁的
unfortunate|不幸的， 倒霉的
recover|痊愈 vt.  恢复； 重新获得
or|或者； 还是， 否则
chance|机会； 可能性
determine|决定； 测定； 确定
nature|自然； 性质； 本性
social|社会的； 社交的； 群居的
wheel|轮， 车轮； 方向盘
interesting|有趣的
cross|十字形的东西；十字架 vt.  越过； 穿过
control|vt&n.   控制
drill|钻；重复训练 n.  钻头；  训练
friction|摩擦； 摩擦力
clerk|书记员； 办事员； 职员
walnut|胡桃， 胡桃木
acknowledge|答谢； 承认
equip|装备； 训练
radiation|放射； 放射物； 放射疗法
quarrel|n&vi.  争吵， 吵架
christian|基督教徒的 n. 基督教徒
pulse|搏动， 跳动 n. 脉搏；脉冲
maple|枫树
spiritual|精神的； 心灵的
worthwhile|值得做的
nation|民族， 国家
upper|较高的， 较上的
splendid|灿烂的， 辉煌的； 〈口语〉 极好的
adaptation|[U] 适应， 适合； [C] 改编本
behalf|利益； 代表
somewhere|在某处， 到某处
scene|一场， 场景， 布景； 景色， 风景
injure|损害， 伤害
freeze|结冰
eastward|向东
geography|地理学
horrible|令人恐惧的， 恐怖的
strengthen|加强， 增强
injury|损伤； 受伤处
diploma|毕业文凭， 学位证书
brand|商标， 牌子
suspension|暂停， 中止； 悬挂， 悬浮
choke|n&v.  窒息
alcohol|酒精， 酒
pleasure|高兴， 愉快
old|老的， 旧的
recreation|消遣， 娱乐
allowance|津贴， 补贴
interpreter|翻译员， 口译人员
hurricane|飓风， 狂风
portable|轻便的， 便携的
then|当时， 那时； 然后； 那么
ancient|古代的， 古老的
accept|接受
glory|光荣， 荣誉
seat|座位，座 vt.  使就座； 可容纳
wander|游荡； 漫步； 流浪
adopt|采用； 收养
oppose|反对
minus|负的 prep.  减去
belly|肚子
conservative|守旧的； 保守主义的； 谨慎的
access|通道；机会，权利 vt.  进入； 存取
conference|会议
primitive|原始的， 远古的
activity|活动
dormitory|学生宿舍
overcome|战胜， 克服， 胜过
recite|背诵
seek|试图； 寻找， 寻求
seem|似乎， 好像
heel|脚后跟
variety|种种； 种类
disturb|打扰， 扰乱
adore|爱慕， 崇拜
lecture|[C] 讲课， 演讲
civilian|平民， 老百姓
so|也，同样〔用于表示刚说过的情况也适用于某人或某物〕 conjunction. 因此，所以 n. 全音阶的第五音
pump|用泵抽水；抽 n.  抽水机， 泵
caution|小心， 谨慎
key|[C] 钥匙； 答案； 键； 关键
teenager|青少年， 十几岁的少年
dumpling|饺子
silent|无声的， 沉默的
decision|决定； 决议
addicted|入迷的， 上瘾的
necessary|必需的， 必要的
one|num&pron.  一个  ； 任何人
garage|汽车间， 汽车库
badminton|羽毛球
confirm|确定； 批准
single|单一的， 单个的
pull|拉，拖 n.  拉力， 引力
unconditional|无条件的， 绝对的
gallon|加仑
appoint|指定， 任命
assist|帮助， 协助
bun|馒头； 小甜面包
but|但是，可是 prep.  除了， 除…外
symbol|符号， 象征
sincerely|真诚地
commercial|商业的， 贸易的
separate|分开，  分离 adj.  单独的， 分开的
declare|宣布， 声明； 申报
reasonable|合理的， 有道理的； 通情达理的， 合乎情理的
dislike|n&vt.  不喜欢， 嫌恶
willing|情愿的， 乐意的
available|有空的； 可得到的， 可用的
express|表达；表示 n.  快车
advocate|提倡； 鼓吹
amazing|令人惊异的
luggage|〈总称〉 行李
drawback|缺点； 障碍
dynamic|有活力的； 动力的， 动力学的
up|从下往上地，向上地 v. 提高；增加
unusual|不平常的， 异常的
extreme|极端的， 偏激的
usual|通常的， 平常的
sink|下沉；消沉；陷入 n.  洗涤槽， 污水槽
degree|程度； 度数； 文凭
astronomy|天文学
suppose|料想 vt. 猜想，假定
brake|刹车 n. 闸
tube|管子
outspoken|坦率的
especially|特别， 尤其
once|一次，一回 conjunction. 一…便，一旦，一经
failure|失败
quake|n&vi.  震动
know|知道， 了解； 认识； 懂得
sing|唱， 唱歌
organise|组织
support|vt&n.  支持， 赞助； 赡养
drop|掉下，落下 n.  滴； 下降
preview|预演， 预习
questionnaire|调查表， 问卷
saucer|茶碟； 小圆盘
hire|租用
breakthrough|突破
idea|主意， 意见； 打算， 想法
destination|目的地
apron|围裙； 台口
vertical|垂直的， 直立的； 纵向的
monument|纪念碑， 纪念物
pure|纯的， 不掺杂的
vivid|生动的， 鲜明的
damp|潮湿的 n. 潮湿；湿气 v. 使潮湿
throughout|遍及， 贯穿
virtue|美德， 正直的品行
overweight|过重的， 超重的
gay|快活的，愉快的 n.   同性恋
successful|成功的， 有成就的
lovely|美好的， 可爱的
normal|正常的 n.  正常， 常态， 普通
gradual|逐渐的， 渐进的
figure|认为；  描绘 n. 数字；人物
socialist|社会主义的 n. 社会主义者
airmail|〈总称〉航空邮件
slight|轻微的， 细小的
corrupt|腐败的，贪污的 v.  腐烂， 腐蚀
wide|宽的， 宽阔的； 广泛的
previous|在前的， 早先的
teach|教书； 教
socialism|社会主义
argue|争论； 说服
technology|技术， 科技
superior|较高的， 上好的 n. 长者；上级
succeed|成功 vt.  继承， 接替
choir|唱诗班
punctual|准时的
advertise|为…做广告
compromise|妥协， 折中
software|软件
seminar|研究会， 讨论发表会
reach|到达；  够到
react|起反应， 起作用； 反抗
competition|比赛， 竞赛
none|无任何东西或人
type|打字， 用打字机打出
beyond|超过；  在…的那边
practise|练习； 实习； 经常做； 养成…的习惯
review|复习；重新调查 n.  复习； 复查； 评论
sight|情景， 风景； 视力
voluntary|自愿的
asleep|睡着的， 熟睡的
nobody|没有人，谁也不 n.  小人物
guide|指导； 指引 n. 向导，导游
between|在之间； 在…中间
surrounding|周围的 n. 围绕；
goal|目标； 进球得分；  球门
collar|衣领
natural|自然的， 天然的； 天生的
overhead|adj&adv.  在高处， 在空中
conclude|推论； 断定； 完成； 结束
come|来，来到 v.  变成
comprehension|理解
leather|皮革
comb|梳 n.  梳子
exist|存在， 生存
unemployment|失业
exact|精确的， 准确的， 确切的
lift|升起，  消散
motto|箴言， 格言
nationwide|全国性的
force|强迫，迫使 n.  力量， 武力
centigrade|摄氏的； 百分度的
botany|植物学； 植物
wear|穿， 戴； 留， 蓄； 磨损， 使变旧
range|范围； 射程
weak|虚弱的； 差的
leak|漏， 泄漏
impress|留下印象
flat|平的 n.  一套房间； 公寓
get|变得； 到达 vt. 得到，获得
course|过程， 经过； 课程
barber|理发师
copy|复制； 抄写； 复印 n. 抄本，副本；一本
precise|精确的， 准确的
power|力量； 动力
place|地方，处所 vt.  放置， 安置
dare|敢， 敢于
regular|规则的； 经常的
precious|宝贵的， 珍贵的
sell|卖， 售
tired|疲劳的， 累的； 厌烦的
tremble|颤抖， 挥动
gymnastics|体操， 体育
suspect|怀疑 n.  犯罪嫌疑人
suggest|建议； 提出； 暗示
apologize|道歉， 谢罪
expect|预料； 期望； 要求
help|n&v.  帮助， 帮忙； 有帮助， 有用
depth|深， 深度
assess|估定， 评定
prescription|处方， 药方
behaviour|[U] 行为， 举止
chorus|合唱
minimum|最小的 n. 最小量，最小值
queue|排队 n.  行列， 长队
apology|道歉； 歉意
date|日期；约会 vt.  约会； 注明日期
magic|有魔力的 n. 魔法，魔术
dress|穿衣，打扮 n.  女服， 连衣裙； 服装
argument|[C] 争论， 辩论
passage|一节； 走廊； 通道
theoretical|理论的
adequate|足够的， 适当的
sound|声，声音 v. 听起来；看起来；好像 adj. 明智的；合理的；正确的
own|自己的 vt.  拥有
hopeful|有希望的； 有前途的
dozen|十二个； 许多
translate|翻译
drug|药， 药物； 毒品
barrier|栅栏， 挡板； 障碍
plain|平常的，普通的；明白的 n.  草原
should|modal verb. 应当，应该 〔用于提供或征求建议〕
only|只， 仅仅 adj. 唯一的，仅有的
create|创造； 造成
justice|正义， 公正； 司法
criminal|罪犯
blow|吹  ； 刮风 n. 击，打击
curious|好奇的； 奇异的
proud|自豪的， 骄傲的
like|喜欢， 喜爱 prep. 像，跟…一样 n. 爱好
ugly|丑陋的， 难看的
earthquake|地震
tax|税， 税款
towards|向， 朝， 对于
messy|乱七八糟的
embassy|大使馆
rectangle|长方形的 n. 长方形
fragile|易碎的， 脆的
departure|离开； 背离； 违反
dash|快跑，猛撞 n.  快跑， 猛撞； 少量
send|打发， 派遣； 送， 邮寄
concrete|具体的； 有形的
note|便条，笔记，注释 vt.  记录， 注意
everybody|每人， 人人
sail|航行，开航 n.  帆； 航行
cab|出租车； 驾驶室
purpose|目的， 意图
regret|遗憾，懊悔；令人遗憾的事 vt.   遗憾； 后悔
line|画线于，  成行 n. 直线；排
stout|结实的， 矮胖的
link|连接，联合 n.  链环， 链接
flee|逃走， 逃跑
weep|哭泣， 流泪
tune|曲调， 调子
aware|知道的， 意识到的
can|罐头； 铁罐； 垃圾桶
security|安全
award|奖品， 奖励
ready|准备就绪的
alarm|警报
weed|野草， 杂草
herb|草药
unconscious|不省人事的， 无意识的
rainfall|一场雨； 降雨量
cost|成本；代价 vt.   花费； 使付出
will|意志； 遗嘱
satisfy|满足， 使满意
smoke|冒烟； 吸烟 n. 烟
match|相配，相称 n.  比赛； 火柴
arbitrary|武断的； 任意的
cuisine|烹饪， 烹饪术
fault|过错， 缺点， 毛病
follow|跟随； 遵循； 仿效
passive|被动的； 消极的
hard-working|勤劳的， 辛勤工作的
carrier|搬运者；  置物架
dignity|尊严； 高贵
challenge|挑战；挑战性 vt.  挑战
category|种类
cosy|暖和舒服的； 舒适的
intend|想要， 打算
wild|野生的
